PokerStars Hand #132865763754: Tournament #1164585221, $20+$2 USD Hold'em No Limit - Level I (10/20) - 2015/03/29 20:30:06 CET [2015/03/29 14:30:06 ET]
Table '1164585221 156' 9-max Seat #1 is the button
Seat 1: FrederickH. (10000 in chips) 
Seat 2: EXskillance (10000 in chips) 
Seat 3: Suvinen (10000 in chips) 
Seat 4: vadim8656 (10000 in chips) 
Seat 5: maXXmilian (10000 in chips) 
Seat 6: taube1981 (10000 in chips) 
Seat 7: casiodk333 (10000 in chips) 
Seat 8: DrimTeam2 (10000 in chips) 
Seat 9: mossy100 (10000 in chips) 
EXskillance: posts small blind 10
Suvinen: posts big blind 20
casiodk333 has returned
*** HOLE CARDS ***
Dealt to casiodk333 [8d Ts]
vadim8656: folds 
maXXmilian: raises 41 to 61
taube1981: calls 61
casiodk333: folds 
DrimTeam2: folds 
mossy100: folds 
FrederickH.: folds 
EXskillance: folds 
Suvinen: folds 
*** FLOP *** [Tc 9c 7s]
maXXmilian: bets 83
taube1981: calls 83
*** TURN *** [Tc 9c 7s] [Td]
maXXmilian: checks 
taube1981: bets 120
maXXmilian: calls 120
*** RIVER *** [Tc 9c 7s Td] [Js]
maXXmilian: checks 
taube1981: checks 
*** SHOW DOWN ***
maXXmilian: shows [Qh Jh] (two pair, Jacks and Tens)
taube1981: shows [Jc As] (two pair, Jacks and Tens - Ace kicker)
taube1981 collected 558 from pot
*** SUMMARY ***
Total pot 558 | Rake 0 
Board [Tc 9c 7s Td Js]
Seat 1: FrederickH. (button) folded before Flop (didn't bet)
Seat 2: EXskillance (small blind) folded before Flop
Seat 3: Suvinen (big blind) folded before Flop
Seat 4: vadim8656 folded before Flop (didn't bet)
Seat 5: maXXmilian showed [Qh Jh] and lost with two pair, Jacks and Tens
Seat 6: taube1981 showed [Jc As] and won (558) with two pair, Jacks and Tens
Seat 7: casiodk333 folded before Flop (didn't bet)
Seat 8: DrimTeam2 folded before Flop (didn't bet)
Seat 9: mossy100 folded before Flop (didn't bet)



PokerStars Hand #132865815811: Tournament #1164585221, $20+$2 USD Hold'em No Limit - Level I (10/20) - 2015/03/29 20:30:55 CET [2015/03/29 14:30:55 ET]
Table '1164585221 156' 9-max Seat #2 is the button
Seat 1: FrederickH. (10000 in chips) 
Seat 2: EXskillance (9990 in chips) 
Seat 3: Suvinen (9980 in chips) 
Seat 4: vadim8656 (10000 in chips) 
Seat 5: maXXmilian (9736 in chips) 
Seat 6: taube1981 (10294 in chips) 
Seat 7: casiodk333 (10000 in chips) 
Seat 8: DrimTeam2 (10000 in chips) 
Seat 9: mossy100 (10000 in chips) 
Suvinen: posts small blind 10
vadim8656: posts big blind 20
*** HOLE CARDS ***
Dealt to casiodk333 [Kd 2s]
maXXmilian: folds 
taube1981: folds 
casiodk333: folds 
DrimTeam2: folds 
mossy100: folds 
FrederickH.: folds 
EXskillance: raises 20 to 40
Suvinen: calls 30
vadim8656: calls 20
*** FLOP *** [5s 2c 5c]
Suvinen: checks 
vadim8656: checks 
EXskillance: bets 59
Suvinen: folds 
vadim8656: folds 
Uncalled bet (59) returned to EXskillance
EXskillance collected 120 from pot
EXskillance: doesn't show hand 
*** SUMMARY ***
Total pot 120 | Rake 0 
Board [5s 2c 5c]
Seat 1: FrederickH. folded before Flop (didn't bet)
Seat 2: EXskillance (button) collected (120)
Seat 3: Suvinen (small blind) folded on the Flop
Seat 4: vadim8656 (big blind) folded on the Flop
Seat 5: maXXmilian folded before Flop (didn't bet)
Seat 6: taube1981 folded before Flop (didn't bet)
Seat 7: casiodk333 folded before Flop (didn't bet)
Seat 8: DrimTeam2 folded before Flop (didn't bet)
Seat 9: mossy100 folded before Flop (didn't bet)



PokerStars Hand #132865873604: Tournament #1164585221, $20+$2 USD Hold'em No Limit - Level I (10/20) - 2015/03/29 20:31:47 CET [2015/03/29 14:31:47 ET]
Table '1164585221 156' 9-max Seat #3 is the button
Seat 1: FrederickH. (10000 in chips) 
Seat 2: EXskillance (10070 in chips) 
Seat 3: Suvinen (9940 in chips) 
Seat 4: vadim8656 (9960 in chips) 
Seat 5: maXXmilian (9736 in chips) 
Seat 6: taube1981 (10294 in chips) 
Seat 7: casiodk333 (10000 in chips) 
Seat 8: DrimTeam2 (10000 in chips) 
Seat 9: mossy100 (10000 in chips) 
vadim8656: posts small blind 10
maXXmilian: posts big blind 20
*** HOLE CARDS ***
Dealt to casiodk333 [Tc 3d]
taube1981: raises 20 to 40
casiodk333: folds 
DrimTeam2: folds 
mossy100 has timed out
mossy100: folds 
mossy100 is sitting out
FrederickH.: folds 
EXskillance: folds 
mossy100 has returned
Suvinen: folds 
vadim8656: folds 
maXXmilian: folds 
Uncalled bet (20) returned to taube1981
taube1981 collected 50 from pot
taube1981: doesn't show hand 
*** SUMMARY ***
Total pot 50 | Rake 0 
Seat 1: FrederickH. folded before Flop (didn't bet)
Seat 2: EXskillance folded before Flop (didn't bet)
Seat 3: Suvinen (button) folded before Flop (didn't bet)
Seat 4: vadim8656 (small blind) folded before Flop
Seat 5: maXXmilian (big blind) folded before Flop
Seat 6: taube1981 collected (50)
Seat 7: casiodk333 folded before Flop (didn't bet)
Seat 8: DrimTeam2 folded before Flop (didn't bet)
Seat 9: mossy100 folded before Flop (didn't bet)



PokerStars Hand #132865941180: Tournament #1164585221, $20+$2 USD Hold'em No Limit - Level I (10/20) - 2015/03/29 20:32:45 CET [2015/03/29 14:32:45 ET]
Table '1164585221 156' 9-max Seat #4 is the button
Seat 1: FrederickH. (10000 in chips) 
Seat 2: EXskillance (10070 in chips) 
Seat 3: Suvinen (9940 in chips) 
Seat 4: vadim8656 (9950 in chips) 
Seat 5: maXXmilian (9716 in chips) 
Seat 6: taube1981 (10324 in chips) 
Seat 7: casiodk333 (10000 in chips) 
Seat 8: DrimTeam2 (10000 in chips) 
Seat 9: mossy100 (10000 in chips) 
maXXmilian: posts small blind 10
taube1981: posts big blind 20
*** HOLE CARDS ***
Dealt to casiodk333 [Qc Ks]
casiodk333: calls 20
DrimTeam2: folds 
mossy100: folds 
FrederickH.: folds 
EXskillance: folds 
Suvinen: folds 
vadim8656: folds 
maXXmilian: folds 
taube1981: checks 
*** FLOP *** [Jd 3s 7d]
taube1981: checks 
casiodk333: bets 30
taube1981: folds 
Uncalled bet (30) returned to casiodk333
casiodk333 collected 50 from pot
*** SUMMARY ***
Total pot 50 | Rake 0 
Board [Jd 3s 7d]
Seat 1: FrederickH. folded before Flop (didn't bet)
Seat 2: EXskillance folded before Flop (didn't bet)
Seat 3: Suvinen folded before Flop (didn't bet)
Seat 4: vadim8656 (button) folded before Flop (didn't bet)
Seat 5: maXXmilian (small blind) folded before Flop
Seat 6: taube1981 (big blind) folded on the Flop
Seat 7: casiodk333 collected (50)
Seat 8: DrimTeam2 folded before Flop (didn't bet)
Seat 9: mossy100 folded before Flop (didn't bet)



PokerStars Hand #132865982730: Tournament #1164585221, $20+$2 USD Hold'em No Limit - Level I (10/20) - 2015/03/29 20:33:19 CET [2015/03/29 14:33:19 ET]
Table '1164585221 156' 9-max Seat #5 is the button
Seat 1: FrederickH. (10000 in chips) 
Seat 2: EXskillance (10070 in chips) 
Seat 3: Suvinen (9940 in chips) 
Seat 4: vadim8656 (9950 in chips) 
Seat 5: maXXmilian (9706 in chips) 
Seat 6: taube1981 (10304 in chips) 
Seat 7: casiodk333 (10030 in chips) 
Seat 8: DrimTeam2 (10000 in chips) 
Seat 9: mossy100 (10000 in chips) 
taube1981: posts small blind 10
casiodk333: posts big blind 20
*** HOLE CARDS ***
Dealt to casiodk333 [Qh 9d]
DrimTeam2: folds 
mossy100: folds 
FrederickH.: folds 
EXskillance: raises 20 to 40
Suvinen: folds 
vadim8656: raises 20 to 60
maXXmilian: folds 
taube1981: folds 
casiodk333: folds 
EXskillance: raises 100 to 160
vadim8656: calls 100
*** FLOP *** [9c 6s 6c]
EXskillance: bets 220
vadim8656: folds 
Uncalled bet (220) returned to EXskillance
EXskillance collected 350 from pot
EXskillance: doesn't show hand 
*** SUMMARY ***
Total pot 350 | Rake 0 
Board [9c 6s 6c]
Seat 1: FrederickH. folded before Flop (didn't bet)
Seat 2: EXskillance collected (350)
Seat 3: Suvinen folded before Flop (didn't bet)
Seat 4: vadim8656 folded on the Flop
Seat 5: maXXmilian (button) folded before Flop (didn't bet)
Seat 6: taube1981 (small blind) folded before Flop
Seat 7: casiodk333 (big blind) folded before Flop
Seat 8: DrimTeam2 folded before Flop (didn't bet)
Seat 9: mossy100 folded before Flop (didn't bet)



PokerStars Hand #132866059845: Tournament #1164585221, $20+$2 USD Hold'em No Limit - Level I (10/20) - 2015/03/29 20:34:24 CET [2015/03/29 14:34:24 ET]
Table '1164585221 156' 9-max Seat #6 is the button
Seat 1: FrederickH. (10000 in chips) 
Seat 2: EXskillance (10260 in chips) 
Seat 3: Suvinen (9940 in chips) 
Seat 4: vadim8656 (9790 in chips) 
Seat 5: maXXmilian (9706 in chips) 
Seat 6: taube1981 (10294 in chips) 
Seat 7: casiodk333 (10010 in chips) 
Seat 8: DrimTeam2 (10000 in chips) 
Seat 9: mossy100 (10000 in chips) 
casiodk333: posts small blind 10
DrimTeam2: posts big blind 20
*** HOLE CARDS ***
Dealt to casiodk333 [Js 9d]
mossy100: folds 
FrederickH.: folds 
EXskillance: folds 
Suvinen: folds 
vadim8656: calls 20
maXXmilian: folds 
taube1981: calls 20
casiodk333: calls 10
DrimTeam2: checks 
*** FLOP *** [3h Jh 6d]
casiodk333: checks 
DrimTeam2: checks 
vadim8656: checks 
taube1981: checks 
*** TURN *** [3h Jh 6d] [3c]
casiodk333: bets 40
DrimTeam2: folds 
vadim8656: calls 40
taube1981: folds 
*** RIVER *** [3h Jh 6d 3c] [7c]
casiodk333: checks 
vadim8656: checks 
*** SHOW DOWN ***
casiodk333: shows [Js 9d] (two pair, Jacks and Threes)
vadim8656: mucks hand 
casiodk333 collected 160 from pot
*** SUMMARY ***
Total pot 160 | Rake 0 
Board [3h Jh 6d 3c 7c]
Seat 1: FrederickH. folded before Flop (didn't bet)
Seat 2: EXskillance folded before Flop (didn't bet)
Seat 3: Suvinen folded before Flop (didn't bet)
Seat 4: vadim8656 mucked [6h 8d]
Seat 5: maXXmilian folded before Flop (didn't bet)
Seat 6: taube1981 (button) folded on the Turn
Seat 7: casiodk333 (small blind) showed [Js 9d] and won (160) with two pair, Jacks and Threes
Seat 8: DrimTeam2 (big blind) folded on the Turn
Seat 9: mossy100 folded before Flop (didn't bet)



PokerStars Hand #132866143972: Tournament #1164585221, $20+$2 USD Hold'em No Limit - Level I (10/20) - 2015/03/29 20:35:37 CET [2015/03/29 14:35:37 ET]
Table '1164585221 156' 9-max Seat #7 is the button
Seat 1: FrederickH. (10000 in chips) 
Seat 2: EXskillance (10260 in chips) 
Seat 3: HaHaUAmateur (10000 in chips) 
Seat 4: vadim8656 (9730 in chips) 
Seat 5: maXXmilian (9706 in chips) 
Seat 6: taube1981 (10274 in chips) 
Seat 7: casiodk333 (10110 in chips) 
Seat 8: DrimTeam2 (9980 in chips) 
Seat 9: mossy100 (10000 in chips) 
DrimTeam2: posts small blind 10
mossy100: posts big blind 20
*** HOLE CARDS ***
Dealt to casiodk333 [Qd 8c]
FrederickH.: folds 
EXskillance: folds 
HaHaUAmateur: folds 
vadim8656: folds 
maXXmilian: folds 
taube1981: raises 20 to 40
casiodk333: folds 
DrimTeam2: folds 
mossy100: calls 20
*** FLOP *** [Ts 9c 2c]
mossy100: checks 
taube1981: checks 
*** TURN *** [Ts 9c 2c] [As]
mossy100: checks 
taube1981: bets 60
mossy100: calls 60
*** RIVER *** [Ts 9c 2c As] [3c]
mossy100: checks 
taube1981: checks 
*** SHOW DOWN ***
mossy100: shows [6c Ad] (a pair of Aces)
taube1981: shows [Ac 6d] (a pair of Aces)
mossy100 collected 105 from pot
taube1981 collected 105 from pot
*** SUMMARY ***
Total pot 210 | Rake 0 
Board [Ts 9c 2c As 3c]
Seat 1: FrederickH. folded before Flop (didn't bet)
Seat 2: EXskillance folded before Flop (didn't bet)
Seat 3: HaHaUAmateur folded before Flop (didn't bet)
Seat 4: vadim8656 folded before Flop (didn't bet)
Seat 5: maXXmilian folded before Flop (didn't bet)
Seat 6: taube1981 showed [Ac 6d] and won (105) with a pair of Aces
Seat 7: casiodk333 (button) folded before Flop (didn't bet)
Seat 8: DrimTeam2 (small blind) folded before Flop
Seat 9: mossy100 (big blind) showed [6c Ad] and won (105) with a pair of Aces



PokerStars Hand #132866198807: Tournament #1164585221, $20+$2 USD Hold'em No Limit - Level I (10/20) - 2015/03/29 20:36:23 CET [2015/03/29 14:36:23 ET]
Table '1164585221 156' 9-max Seat #8 is the button
Seat 1: FrederickH. (10000 in chips) 
Seat 2: EXskillance (10260 in chips) 
Seat 3: HaHaUAmateur (10000 in chips) 
Seat 4: vadim8656 (9730 in chips) 
Seat 5: maXXmilian (9706 in chips) 
Seat 6: taube1981 (10279 in chips) 
Seat 7: casiodk333 (10110 in chips) 
Seat 8: DrimTeam2 (9970 in chips) 
Seat 9: mossy100 (10005 in chips) 
mossy100: posts small blind 10
FrederickH.: posts big blind 20
*** HOLE CARDS ***
Dealt to casiodk333 [3s Kd]
EXskillance: folds 
HaHaUAmateur: folds 
vadim8656: folds 
maXXmilian: raises 41 to 61
taube1981: folds 
casiodk333: folds 
DrimTeam2: folds 
mossy100: folds 
FrederickH.: calls 41
*** FLOP *** [Qh 9d 3h]
FrederickH.: checks 
maXXmilian: bets 65
FrederickH.: folds 
Uncalled bet (65) returned to maXXmilian
maXXmilian collected 132 from pot
*** SUMMARY ***
Total pot 132 | Rake 0 
Board [Qh 9d 3h]
Seat 1: FrederickH. (big blind) folded on the Flop
Seat 2: EXskillance folded before Flop (didn't bet)
Seat 3: HaHaUAmateur folded before Flop (didn't bet)
Seat 4: vadim8656 folded before Flop (didn't bet)
Seat 5: maXXmilian collected (132)
Seat 6: taube1981 folded before Flop (didn't bet)
Seat 7: casiodk333 folded before Flop (didn't bet)
Seat 8: DrimTeam2 (button) folded before Flop (didn't bet)
Seat 9: mossy100 (small blind) folded before Flop



PokerStars Hand #132866242007: Tournament #1164585221, $20+$2 USD Hold'em No Limit - Level I (10/20) - 2015/03/29 20:37:00 CET [2015/03/29 14:37:00 ET]
Table '1164585221 156' 9-max Seat #9 is the button
Seat 1: FrederickH. (9939 in chips) 
Seat 2: EXskillance (10260 in chips) 
Seat 3: HaHaUAmateur (10000 in chips) 
Seat 4: vadim8656 (9730 in chips) 
Seat 5: maXXmilian (9777 in chips) 
Seat 6: taube1981 (10279 in chips) 
Seat 7: casiodk333 (10110 in chips) 
Seat 8: DrimTeam2 (9970 in chips) 
Seat 9: mossy100 (9995 in chips) 
FrederickH.: posts small blind 10
EXskillance: posts big blind 20
*** HOLE CARDS ***
Dealt to casiodk333 [Ah 8s]
HaHaUAmateur: folds 
vadim8656: calls 20
maXXmilian: folds 
taube1981: folds 
casiodk333: folds 
DrimTeam2: folds 
mossy100: folds 
FrederickH.: calls 10
EXskillance: checks 
*** FLOP *** [3h Qh As]
FrederickH.: checks 
EXskillance: bets 30
vadim8656: calls 30
FrederickH.: calls 30
*** TURN *** [3h Qh As] [3d]
FrederickH.: checks 
EXskillance: checks 
vadim8656: checks 
*** RIVER *** [3h Qh As 3d] [2h]
FrederickH.: bets 120
EXskillance: folds 
vadim8656: calls 120
*** SHOW DOWN ***
FrederickH.: shows [5s 4h] (a straight, Ace to Five)
vadim8656: mucks hand 
FrederickH. collected 390 from pot
*** SUMMARY ***
Total pot 390 | Rake 0 
Board [3h Qh As 3d 2h]
Seat 1: FrederickH. (small blind) showed [5s 4h] and won (390) with a straight, Ace to Five
Seat 2: EXskillance (big blind) folded on the River
Seat 3: HaHaUAmateur folded before Flop (didn't bet)
Seat 4: vadim8656 mucked [4c Ac]
Seat 5: maXXmilian folded before Flop (didn't bet)
Seat 6: taube1981 folded before Flop (didn't bet)
Seat 7: casiodk333 folded before Flop (didn't bet)
Seat 8: DrimTeam2 folded before Flop (didn't bet)
Seat 9: mossy100 (button) folded before Flop (didn't bet)



PokerStars Hand #132866332781: Tournament #1164585221, $20+$2 USD Hold'em No Limit - Level I (10/20) - 2015/03/29 20:38:18 CET [2015/03/29 14:38:18 ET]
Table '1164585221 156' 9-max Seat #1 is the button
Seat 1: FrederickH. (10159 in chips) 
Seat 2: EXskillance (10210 in chips) 
Seat 3: HaHaUAmateur (10000 in chips) 
Seat 4: vadim8656 (9560 in chips) 
Seat 5: maXXmilian (9777 in chips) 
Seat 6: taube1981 (10279 in chips) 
Seat 7: casiodk333 (10110 in chips) 
Seat 8: DrimTeam2 (9970 in chips) 
Seat 9: mossy100 (9995 in chips) 
EXskillance: posts small blind 10
HaHaUAmateur: posts big blind 20
*** HOLE CARDS ***
Dealt to casiodk333 [Ad 3d]
vadim8656: folds 
maXXmilian: folds 
taube1981: folds 
casiodk333: calls 20
DrimTeam2: folds 
mossy100: folds 
FrederickH.: calls 20
EXskillance: folds 
HaHaUAmateur: checks 
*** FLOP *** [6d 8h Jh]
HaHaUAmateur: checks 
casiodk333: checks 
FrederickH.: checks 
*** TURN *** [6d 8h Jh] [Ks]
HaHaUAmateur: checks 
casiodk333: checks 
FrederickH.: checks 
*** RIVER *** [6d 8h Jh Ks] [Qc]
HaHaUAmateur: checks 
casiodk333: checks 
FrederickH.: checks 
*** SHOW DOWN ***
HaHaUAmateur: shows [6c 9s] (a pair of Sixes)
casiodk333: mucks hand 
FrederickH.: shows [6h 7s] (a pair of Sixes)
HaHaUAmateur collected 35 from pot
FrederickH. collected 35 from pot
*** SUMMARY ***
Total pot 70 | Rake 0 
Board [6d 8h Jh Ks Qc]
Seat 1: FrederickH. (button) showed [6h 7s] and won (35) with a pair of Sixes
Seat 2: EXskillance (small blind) folded before Flop
Seat 3: HaHaUAmateur (big blind) showed [6c 9s] and won (35) with a pair of Sixes
Seat 4: vadim8656 folded before Flop (didn't bet)
Seat 5: maXXmilian folded before Flop (didn't bet)
Seat 6: taube1981 folded before Flop (didn't bet)
Seat 7: casiodk333 mucked [Ad 3d]
Seat 8: DrimTeam2 folded before Flop (didn't bet)
Seat 9: mossy100 folded before Flop (didn't bet)



PokerStars Hand #132866415322: Tournament #1164585221, $20+$2 USD Hold'em No Limit - Level I (10/20) - 2015/03/29 20:39:27 CET [2015/03/29 14:39:27 ET]
Table '1164585221 156' 9-max Seat #2 is the button
Seat 1: FrederickH. (10174 in chips) 
Seat 2: EXskillance (10200 in chips) 
Seat 3: HaHaUAmateur (10015 in chips) 
Seat 4: vadim8656 (9560 in chips) 
Seat 5: maXXmilian (9777 in chips) 
Seat 6: taube1981 (10279 in chips) 
Seat 7: casiodk333 (10090 in chips) 
Seat 8: DrimTeam2 (9970 in chips) 
Seat 9: mossy100 (9995 in chips) 
HaHaUAmateur: posts small blind 10
vadim8656: posts big blind 20
*** HOLE CARDS ***
Dealt to casiodk333 [Qc 3d]
maXXmilian: folds 
taube1981: folds 
casiodk333: folds 
DrimTeam2: folds 
mossy100: folds 
FrederickH.: folds 
EXskillance: folds 
HaHaUAmateur: raises 40 to 60
vadim8656: folds 
Uncalled bet (40) returned to HaHaUAmateur
HaHaUAmateur collected 40 from pot
HaHaUAmateur: doesn't show hand 
*** SUMMARY ***
Total pot 40 | Rake 0 
Seat 1: FrederickH. folded before Flop (didn't bet)
Seat 2: EXskillance (button) folded before Flop (didn't bet)
Seat 3: HaHaUAmateur (small blind) collected (40)
Seat 4: vadim8656 (big blind) folded before Flop
Seat 5: maXXmilian folded before Flop (didn't bet)
Seat 6: taube1981 folded before Flop (didn't bet)
Seat 7: casiodk333 folded before Flop (didn't bet)
Seat 8: DrimTeam2 folded before Flop (didn't bet)
Seat 9: mossy100 folded before Flop (didn't bet)



PokerStars Hand #132866451368: Tournament #1164585221, $20+$2 USD Hold'em No Limit - Level I (10/20) - 2015/03/29 20:39:56 CET [2015/03/29 14:39:56 ET]
Table '1164585221 156' 9-max Seat #3 is the button
Seat 1: FrederickH. (10174 in chips) 
Seat 2: EXskillance (10200 in chips) 
Seat 3: HaHaUAmateur (10035 in chips) 
Seat 4: vadim8656 (9540 in chips) 
Seat 5: maXXmilian (9777 in chips) 
Seat 6: taube1981 (10279 in chips) 
Seat 7: casiodk333 (10090 in chips) 
Seat 8: DrimTeam2 (9970 in chips) 
Seat 9: mossy100 (9995 in chips) 
vadim8656: posts small blind 10
maXXmilian: posts big blind 20
*** HOLE CARDS ***
Dealt to casiodk333 [Kc As]
taube1981: folds 
casiodk333: calls 20
DrimTeam2: folds 
mossy100: raises 70 to 90
FrederickH.: folds 
EXskillance: raises 180 to 270
HaHaUAmateur: folds 
vadim8656: folds 
maXXmilian: folds 
casiodk333: calls 250
mossy100: calls 180
*** FLOP *** [Qh 4c Th]
casiodk333: checks 
mossy100: checks 
EXskillance: bets 385
casiodk333: calls 385
mossy100: folds 
*** TURN *** [Qh 4c Th] [8c]
casiodk333: checks 
EXskillance: bets 795
casiodk333: calls 795
*** RIVER *** [Qh 4c Th 8c] [Kd]
casiodk333: checks 
EXskillance: bets 1695
casiodk333: calls 1695
*** SHOW DOWN ***
EXskillance: shows [Ad Kh] (a pair of Kings)
casiodk333: shows [Kc As] (a pair of Kings)
casiodk333 collected 3295 from pot
EXskillance collected 3295 from pot
*** SUMMARY ***
Total pot 6590 | Rake 0 
Board [Qh 4c Th 8c Kd]
Seat 1: FrederickH. folded before Flop (didn't bet)
Seat 2: EXskillance showed [Ad Kh] and won (3295) with a pair of Kings
Seat 3: HaHaUAmateur (button) folded before Flop (didn't bet)
Seat 4: vadim8656 (small blind) folded before Flop
Seat 5: maXXmilian (big blind) folded before Flop
Seat 6: taube1981 folded before Flop (didn't bet)
Seat 7: casiodk333 showed [Kc As] and won (3295) with a pair of Kings
Seat 8: DrimTeam2 folded before Flop (didn't bet)
Seat 9: mossy100 folded on the Flop



PokerStars Hand #132866591877: Tournament #1164585221, $20+$2 USD Hold'em No Limit - Level II (15/30) - 2015/03/29 20:41:53 CET [2015/03/29 14:41:53 ET]
Table '1164585221 156' 9-max Seat #4 is the button
Seat 1: FrederickH. (10174 in chips) 
Seat 2: EXskillance (10350 in chips) 
Seat 3: HaHaUAmateur (10035 in chips) 
Seat 4: vadim8656 (9530 in chips) 
Seat 5: maXXmilian (9757 in chips) 
Seat 6: taube1981 (10279 in chips) 
Seat 7: casiodk333 (10240 in chips) 
Seat 8: DrimTeam2 (9970 in chips) 
Seat 9: mossy100 (9725 in chips) 
maXXmilian: posts small blind 15
taube1981: posts big blind 30
*** HOLE CARDS ***
Dealt to casiodk333 [Qc 6h]
casiodk333 said, "everybody loves a chop put"
casiodk333: folds 
DrimTeam2: folds 
mossy100: folds 
EXskillance said, "lol"
FrederickH.: folds 
casiodk333 said, "pot"
casiodk333 said, ":)"
EXskillance said, "u as stubborn as me lol"
EXskillance: raises 60 to 90
HaHaUAmateur: folds 
vadim8656: calls 90
maXXmilian: folds 
taube1981: folds 
*** FLOP *** [6s Qd Ks]
casiodk333 said, "i had a feeling u had a k"
EXskillance: bets 109
vadim8656: calls 109
*** TURN *** [6s Qd Ks] [Js]
casiodk333 said, "or a q"
EXskillance: bets 148
vadim8656: calls 148
*** RIVER *** [6s Qd Ks Js] [5s]
EXskillance: bets 554
vadim8656: calls 554
*** SHOW DOWN ***
EXskillance: shows [Qs Ad] (a flush, King high)
vadim8656: mucks hand 
EXskillance collected 1847 from pot
*** SUMMARY ***
Total pot 1847 | Rake 0 
Board [6s Qd Ks Js 5s]
Seat 1: FrederickH. folded before Flop (didn't bet)
Seat 2: EXskillance showed [Qs Ad] and won (1847) with a flush, King high
Seat 3: HaHaUAmateur folded before Flop (didn't bet)
Seat 4: vadim8656 (button) mucked [Kh Ts]
Seat 5: maXXmilian (small blind) folded before Flop
Seat 6: taube1981 (big blind) folded before Flop
Seat 7: casiodk333 folded before Flop (didn't bet)
Seat 8: DrimTeam2 folded before Flop (didn't bet)
Seat 9: mossy100 folded before Flop (didn't bet)



PokerStars Hand #132866682726: Tournament #1164585221, $20+$2 USD Hold'em No Limit - Level II (15/30) - 2015/03/29 20:43:07 CET [2015/03/29 14:43:07 ET]
Table '1164585221 156' 9-max Seat #5 is the button
Seat 1: FrederickH. (10174 in chips) 
Seat 2: EXskillance (11296 in chips) 
Seat 3: HaHaUAmateur (10035 in chips) 
Seat 4: vadim8656 (8629 in chips) 
Seat 5: maXXmilian (9742 in chips) 
Seat 6: taube1981 (10249 in chips) 
Seat 7: casiodk333 (10240 in chips) 
Seat 8: DrimTeam2 (9970 in chips) 
Seat 9: mossy100 (9725 in chips) 
taube1981: posts small blind 15
casiodk333: posts big blind 30
*** HOLE CARDS ***
Dealt to casiodk333 [Kh 3c]
DrimTeam2: folds 
mossy100: folds 
FrederickH.: folds 
EXskillance: folds 
HaHaUAmateur: raises 60 to 90
vadim8656: folds 
maXXmilian: folds 
taube1981: calls 75
casiodk333: folds 
*** FLOP *** [Ah 2h 8s]
taube1981: checks 
HaHaUAmateur: bets 159
taube1981: raises 561 to 720
HaHaUAmateur: calls 561
*** TURN *** [Ah 2h 8s] [7h]
taube1981: bets 960
HaHaUAmateur: folds 
Uncalled bet (960) returned to taube1981
taube1981 collected 1650 from pot
taube1981: doesn't show hand 
*** SUMMARY ***
Total pot 1650 | Rake 0 
Board [Ah 2h 8s 7h]
Seat 1: FrederickH. folded before Flop (didn't bet)
Seat 2: EXskillance folded before Flop (didn't bet)
Seat 3: HaHaUAmateur folded on the Turn
Seat 4: vadim8656 folded before Flop (didn't bet)
Seat 5: maXXmilian (button) folded before Flop (didn't bet)
Seat 6: taube1981 (small blind) collected (1650)
Seat 7: casiodk333 (big blind) folded before Flop
Seat 8: DrimTeam2 folded before Flop (didn't bet)
Seat 9: mossy100 folded before Flop (didn't bet)



PokerStars Hand #132866806279: Tournament #1164585221, $20+$2 USD Hold'em No Limit - Level II (15/30) - 2015/03/29 20:44:51 CET [2015/03/29 14:44:51 ET]
Table '1164585221 156' 9-max Seat #6 is the button
Seat 1: FrederickH. (10174 in chips) 
Seat 2: EXskillance (11296 in chips) 
Seat 3: HaHaUAmateur (9225 in chips) 
Seat 4: vadim8656 (8629 in chips) 
Seat 5: maXXmilian (9742 in chips) 
Seat 6: taube1981 (11089 in chips) 
Seat 7: casiodk333 (10210 in chips) 
Seat 8: DrimTeam2 (9970 in chips) 
Seat 9: mossy100 (9725 in chips) 
casiodk333: posts small blind 15
DrimTeam2: posts big blind 30
*** HOLE CARDS ***
Dealt to casiodk333 [5s 6s]
mossy100: folds 
FrederickH.: folds 
EXskillance: folds 
HaHaUAmateur: raises 60 to 90
vadim8656: calls 90
maXXmilian: folds 
taube1981: calls 90
casiodk333: calls 75
DrimTeam2: folds 
*** FLOP *** [Kc Ac Kh]
casiodk333: bets 185
HaHaUAmateur: calls 185
vadim8656: folds 
taube1981: folds 
*** TURN *** [Kc Ac Kh] [Jd]
casiodk333: checks 
HaHaUAmateur: checks 
*** RIVER *** [Kc Ac Kh Jd] [8h]
casiodk333: bets 899
HaHaUAmateur: calls 899
*** SHOW DOWN ***
casiodk333: shows [5s 6s] (a pair of Kings)
HaHaUAmateur: shows [Ks Ts] (three of a kind, Kings)
HaHaUAmateur collected 2558 from pot
*** SUMMARY ***
Total pot 2558 | Rake 0 
Board [Kc Ac Kh Jd 8h]
Seat 1: FrederickH. folded before Flop (didn't bet)
Seat 2: EXskillance folded before Flop (didn't bet)
Seat 3: HaHaUAmateur showed [Ks Ts] and won (2558) with three of a kind, Kings
Seat 4: vadim8656 folded on the Flop
Seat 5: maXXmilian folded before Flop (didn't bet)
Seat 6: taube1981 (button) folded on the Flop
Seat 7: casiodk333 (small blind) showed [5s 6s] and lost with a pair of Kings
Seat 8: DrimTeam2 (big blind) folded before Flop
Seat 9: mossy100 folded before Flop (didn't bet)



PokerStars Hand #132866930187: Tournament #1164585221, $20+$2 USD Hold'em No Limit - Level II (15/30) - 2015/03/29 20:46:36 CET [2015/03/29 14:46:36 ET]
Table '1164585221 156' 9-max Seat #7 is the button
Seat 1: FrederickH. (10174 in chips) 
Seat 2: EXskillance (11296 in chips) 
Seat 3: HaHaUAmateur (10609 in chips) 
Seat 4: vadim8656 (8539 in chips) 
Seat 5: maXXmilian (9742 in chips) 
Seat 6: taube1981 (10999 in chips) 
Seat 7: casiodk333 (9036 in chips) 
Seat 8: DrimTeam2 (9940 in chips) 
Seat 9: mossy100 (9725 in chips) 
DrimTeam2: posts small blind 15
mossy100: posts big blind 30
*** HOLE CARDS ***
Dealt to casiodk333 [Kd 4d]
FrederickH.: folds 
EXskillance: folds 
HaHaUAmateur: folds 
vadim8656: calls 30
maXXmilian: folds 
taube1981: folds 
casiodk333: calls 30
DrimTeam2: folds 
mossy100: checks 
*** FLOP *** [Th 6c Ts]
mossy100: checks 
vadim8656: bets 30
casiodk333: folds 
mossy100: folds 
Uncalled bet (30) returned to vadim8656
vadim8656 collected 105 from pot
vadim8656: doesn't show hand 
*** SUMMARY ***
Total pot 105 | Rake 0 
Board [Th 6c Ts]
Seat 1: FrederickH. folded before Flop (didn't bet)
Seat 2: EXskillance folded before Flop (didn't bet)
Seat 3: HaHaUAmateur folded before Flop (didn't bet)
Seat 4: vadim8656 collected (105)
Seat 5: maXXmilian folded before Flop (didn't bet)
Seat 6: taube1981 folded before Flop (didn't bet)
Seat 7: casiodk333 (button) folded on the Flop
Seat 8: DrimTeam2 (small blind) folded before Flop
Seat 9: mossy100 (big blind) folded on the Flop



PokerStars Hand #132866975671: Tournament #1164585221, $20+$2 USD Hold'em No Limit - Level II (15/30) - 2015/03/29 20:47:13 CET [2015/03/29 14:47:13 ET]
Table '1164585221 156' 9-max Seat #8 is the button
Seat 1: FrederickH. (10174 in chips) 
Seat 2: EXskillance (11296 in chips) 
Seat 3: HaHaUAmateur (10609 in chips) 
Seat 4: vadim8656 (8614 in chips) 
Seat 5: maXXmilian (9742 in chips) 
Seat 6: taube1981 (10999 in chips) 
Seat 7: casiodk333 (9006 in chips) 
Seat 8: DrimTeam2 (9925 in chips) 
Seat 9: mossy100 (9695 in chips) 
mossy100: posts small blind 15
FrederickH.: posts big blind 30
*** HOLE CARDS ***
Dealt to casiodk333 [2s Qd]
EXskillance: folds 
HaHaUAmateur: folds 
vadim8656: calls 30
maXXmilian: folds 
taube1981 has timed out
taube1981: folds 
taube1981 is sitting out
casiodk333: folds 
taube1981 has returned
DrimTeam2: folds 
mossy100: raises 150 to 180
FrederickH.: folds 
vadim8656: calls 150
*** FLOP *** [9h 6c Ks]
mossy100: bets 390
vadim8656: calls 390
*** TURN *** [9h 6c Ks] [As]
mossy100: checks 
vadim8656: checks 
*** RIVER *** [9h 6c Ks As] [5s]
mossy100: bets 1290
vadim8656: calls 1290
*** SHOW DOWN ***
mossy100: shows [Kc Ad] (two pair, Aces and Kings)
vadim8656: mucks hand 
mossy100 collected 3750 from pot
*** SUMMARY ***
Total pot 3750 | Rake 0 
Board [9h 6c Ks As 5s]
Seat 1: FrederickH. (big blind) folded before Flop
Seat 2: EXskillance folded before Flop (didn't bet)
Seat 3: HaHaUAmateur folded before Flop (didn't bet)
Seat 4: vadim8656 mucked [5h Kh]
Seat 5: maXXmilian folded before Flop (didn't bet)
Seat 6: taube1981 folded before Flop (didn't bet)
Seat 7: casiodk333 folded before Flop (didn't bet)
Seat 8: DrimTeam2 (button) folded before Flop (didn't bet)
Seat 9: mossy100 (small blind) showed [Kc Ad] and won (3750) with two pair, Aces and Kings



PokerStars Hand #132867067822: Tournament #1164585221, $20+$2 USD Hold'em No Limit - Level II (15/30) - 2015/03/29 20:48:29 CET [2015/03/29 14:48:29 ET]
Table '1164585221 156' 9-max Seat #9 is the button
Seat 1: FrederickH. (10144 in chips) 
Seat 2: EXskillance (11296 in chips) 
Seat 3: HaHaUAmateur (10609 in chips) 
Seat 4: vadim8656 (6754 in chips) 
Seat 5: maXXmilian (9742 in chips) 
Seat 6: taube1981 (10999 in chips) 
Seat 7: casiodk333 (9006 in chips) 
Seat 8: DrimTeam2 (9925 in chips) 
Seat 9: mossy100 (11585 in chips) 
FrederickH.: posts small blind 15
EXskillance: posts big blind 30
*** HOLE CARDS ***
Dealt to casiodk333 [4h Kh]
HaHaUAmateur: folds 
vadim8656: raises 75 to 105
maXXmilian: folds 
taube1981: folds 
casiodk333: folds 
DrimTeam2: folds 
mossy100: folds 
FrederickH.: folds 
EXskillance: folds 
Uncalled bet (75) returned to vadim8656
vadim8656 collected 75 from pot
vadim8656: doesn't show hand 
*** SUMMARY ***
Total pot 75 | Rake 0 
Seat 1: FrederickH. (small blind) folded before Flop
Seat 2: EXskillance (big blind) folded before Flop
Seat 3: HaHaUAmateur folded before Flop (didn't bet)
Seat 4: vadim8656 collected (75)
Seat 5: maXXmilian folded before Flop (didn't bet)
Seat 6: taube1981 folded before Flop (didn't bet)
Seat 7: casiodk333 folded before Flop (didn't bet)
Seat 8: DrimTeam2 folded before Flop (didn't bet)
Seat 9: mossy100 (button) folded before Flop (didn't bet)



PokerStars Hand #132867109497: Tournament #1164585221, $20+$2 USD Hold'em No Limit - Level II (15/30) - 2015/03/29 20:49:05 CET [2015/03/29 14:49:05 ET]
Table '1164585221 156' 9-max Seat #1 is the button
Seat 1: FrederickH. (10129 in chips) 
Seat 2: EXskillance (11266 in chips) 
Seat 3: HaHaUAmateur (10609 in chips) 
Seat 4: vadim8656 (6799 in chips) 
Seat 5: maXXmilian (9742 in chips) 
Seat 6: taube1981 (10999 in chips) 
Seat 7: casiodk333 (9006 in chips) 
Seat 8: DrimTeam2 (9925 in chips) 
Seat 9: mossy100 (11585 in chips) 
EXskillance: posts small blind 15
HaHaUAmateur: posts big blind 30
*** HOLE CARDS ***
Dealt to casiodk333 [Jc 5s]
vadim8656: calls 30
maXXmilian: folds 
taube1981: folds 
casiodk333: folds 
DrimTeam2: folds 
mossy100: folds 
FrederickH.: calls 30
EXskillance: calls 15
HaHaUAmateur: checks 
*** FLOP *** [4s 7d Kd]
EXskillance: checks 
HaHaUAmateur: checks 
vadim8656: bets 30
FrederickH.: folds 
EXskillance: calls 30
HaHaUAmateur: folds 
*** TURN *** [4s 7d Kd] [3h]
EXskillance: checks 
vadim8656: bets 30
EXskillance: calls 30
*** RIVER *** [4s 7d Kd 3h] [8h]
EXskillance: bets 960
vadim8656: folds 
Uncalled bet (960) returned to EXskillance
EXskillance collected 240 from pot
EXskillance: doesn't show hand 
*** SUMMARY ***
Total pot 240 | Rake 0 
Board [4s 7d Kd 3h 8h]
Seat 1: FrederickH. (button) folded on the Flop
Seat 2: EXskillance (small blind) collected (240)
Seat 3: HaHaUAmateur (big blind) folded on the Flop
Seat 4: vadim8656 folded on the River
Seat 5: maXXmilian folded before Flop (didn't bet)
Seat 6: taube1981 folded before Flop (didn't bet)
Seat 7: casiodk333 folded before Flop (didn't bet)
Seat 8: DrimTeam2 folded before Flop (didn't bet)
Seat 9: mossy100 folded before Flop (didn't bet)



PokerStars Hand #132867266157: Tournament #1164585221, $20+$2 USD Hold'em No Limit - Level III (20/40) - 2015/03/29 20:51:18 CET [2015/03/29 14:51:18 ET]
Table '1164585221 156' 9-max Seat #2 is the button
Seat 1: FrederickH. (10099 in chips) 
Seat 2: EXskillance (11416 in chips) 
Seat 3: HaHaUAmateur (10579 in chips) 
Seat 4: vadim8656 (6709 in chips) 
Seat 5: maXXmilian (9742 in chips) 
Seat 6: taube1981 (10999 in chips) 
Seat 7: casiodk333 (9006 in chips) 
Seat 8: DrimTeam2 (9925 in chips) 
Seat 9: mossy100 (11585 in chips) 
HaHaUAmateur: posts small blind 20
vadim8656: posts big blind 40
*** HOLE CARDS ***
Dealt to casiodk333 [Kc 6c]
maXXmilian: folds 
taube1981: folds 
casiodk333: raises 60 to 100
DrimTeam2: folds 
mossy100: folds 
FrederickH.: calls 100
EXskillance: folds 
HaHaUAmateur: folds 
vadim8656: calls 60
*** FLOP *** [9h 8h Kh]
vadim8656: checks 
casiodk333: bets 240
FrederickH.: folds 
vadim8656: calls 240
*** TURN *** [9h 8h Kh] [5c]
vadim8656: checks 
casiodk333: checks 
*** RIVER *** [9h 8h Kh 5c] [3d]
vadim8656: checks 
casiodk333: checks 
*** SHOW DOWN ***
vadim8656: shows [Qh 6s] (high card King)
casiodk333: shows [Kc 6c] (a pair of Kings)
casiodk333 collected 800 from pot
*** SUMMARY ***
Total pot 800 | Rake 0 
Board [9h 8h Kh 5c 3d]
Seat 1: FrederickH. folded on the Flop
Seat 2: EXskillance (button) folded before Flop (didn't bet)
Seat 3: HaHaUAmateur (small blind) folded before Flop
Seat 4: vadim8656 (big blind) showed [Qh 6s] and lost with high card King
Seat 5: maXXmilian folded before Flop (didn't bet)
Seat 6: taube1981 folded before Flop (didn't bet)
Seat 7: casiodk333 showed [Kc 6c] and won (800) with a pair of Kings
Seat 8: DrimTeam2 folded before Flop (didn't bet)
Seat 9: mossy100 folded before Flop (didn't bet)



PokerStars Hand #132867356162: Tournament #1164585221, $20+$2 USD Hold'em No Limit - Level III (20/40) - 2015/03/29 20:52:34 CET [2015/03/29 14:52:34 ET]
Table '1164585221 156' 9-max Seat #3 is the button
Seat 1: FrederickH. (9999 in chips) 
Seat 2: EXskillance (11416 in chips) 
Seat 3: HaHaUAmateur (10559 in chips) 
Seat 4: vadim8656 (6369 in chips) 
Seat 5: maXXmilian (9742 in chips) 
Seat 6: taube1981 (10999 in chips) 
Seat 7: casiodk333 (9466 in chips) 
Seat 8: DrimTeam2 (9925 in chips) 
Seat 9: mossy100 (11585 in chips) 
vadim8656: posts small blind 20
maXXmilian: posts big blind 40
*** HOLE CARDS ***
Dealt to casiodk333 [5h 8d]
taube1981: folds 
casiodk333: folds 
DrimTeam2: folds 
mossy100: folds 
FrederickH.: folds 
EXskillance: folds 
HaHaUAmateur: raises 44 to 84
vadim8656: folds 
maXXmilian: folds 
Uncalled bet (44) returned to HaHaUAmateur
HaHaUAmateur collected 100 from pot
HaHaUAmateur: doesn't show hand 
*** SUMMARY ***
Total pot 100 | Rake 0 
Seat 1: FrederickH. folded before Flop (didn't bet)
Seat 2: EXskillance folded before Flop (didn't bet)
Seat 3: HaHaUAmateur (button) collected (100)
Seat 4: vadim8656 (small blind) folded before Flop
Seat 5: maXXmilian (big blind) folded before Flop
Seat 6: taube1981 folded before Flop (didn't bet)
Seat 7: casiodk333 folded before Flop (didn't bet)
Seat 8: DrimTeam2 folded before Flop (didn't bet)
Seat 9: mossy100 folded before Flop (didn't bet)



PokerStars Hand #132867415454: Tournament #1164585221, $20+$2 USD Hold'em No Limit - Level III (20/40) - 2015/03/29 20:53:23 CET [2015/03/29 14:53:23 ET]
Table '1164585221 156' 9-max Seat #4 is the button
Seat 1: FrederickH. (9999 in chips) 
Seat 2: EXskillance (11416 in chips) 
Seat 3: HaHaUAmateur (10619 in chips) 
Seat 4: vadim8656 (6349 in chips) 
Seat 5: maXXmilian (9702 in chips) 
Seat 6: taube1981 (10999 in chips) 
Seat 7: casiodk333 (9466 in chips) 
Seat 8: DrimTeam2 (9925 in chips) 
Seat 9: mossy100 (11585 in chips) 
maXXmilian: posts small blind 20
taube1981: posts big blind 40
*** HOLE CARDS ***
Dealt to casiodk333 [8d 3s]
casiodk333: folds 
DrimTeam2: raises 120 to 160
mossy100: folds 
FrederickH.: folds 
EXskillance: folds 
HaHaUAmateur: folds 
vadim8656: calls 160
maXXmilian: folds 
taube1981: folds 
*** FLOP *** [Tc 3c Kd]
DrimTeam2: checks 
vadim8656: checks 
*** TURN *** [Tc 3c Kd] [3d]
DrimTeam2: checks 
vadim8656: bets 190
DrimTeam2: calls 190
*** RIVER *** [Tc 3c Kd 3d] [2d]
DrimTeam2: checks 
vadim8656: bets 760
DrimTeam2: folds 
Uncalled bet (760) returned to vadim8656
vadim8656 collected 760 from pot
vadim8656: doesn't show hand 
*** SUMMARY ***
Total pot 760 | Rake 0 
Board [Tc 3c Kd 3d 2d]
Seat 1: FrederickH. folded before Flop (didn't bet)
Seat 2: EXskillance folded before Flop (didn't bet)
Seat 3: HaHaUAmateur folded before Flop (didn't bet)
Seat 4: vadim8656 (button) collected (760)
Seat 5: maXXmilian (small blind) folded before Flop
Seat 6: taube1981 (big blind) folded before Flop
Seat 7: casiodk333 folded before Flop (didn't bet)
Seat 8: DrimTeam2 folded on the River
Seat 9: mossy100 folded before Flop (didn't bet)



PokerStars Hand #132867505811: Tournament #1164585221, $20+$2 USD Hold'em No Limit - Level III (20/40) - 2015/03/29 20:54:40 CET [2015/03/29 14:54:40 ET]
Table '1164585221 156' 9-max Seat #5 is the button
Seat 1: FrederickH. (9999 in chips) 
Seat 2: EXskillance (11416 in chips) 
Seat 3: HaHaUAmateur (10619 in chips) 
Seat 4: vadim8656 (6759 in chips) 
Seat 5: maXXmilian (9682 in chips) 
Seat 6: taube1981 (10959 in chips) 
Seat 7: casiodk333 (9466 in chips) 
Seat 8: DrimTeam2 (9575 in chips) 
Seat 9: mossy100 (11585 in chips) 
taube1981: posts small blind 20
casiodk333: posts big blind 40
*** HOLE CARDS ***
Dealt to casiodk333 [8c Kc]
DrimTeam2: folds 
mossy100: folds 
FrederickH.: folds 
EXskillance: raises 40 to 80
HaHaUAmateur: folds 
vadim8656: calls 80
maXXmilian: folds 
taube1981: folds 
casiodk333: calls 40
*** FLOP *** [6d 4s 7d]
casiodk333: checks 
EXskillance: bets 156
vadim8656: calls 156
casiodk333: calls 156
*** TURN *** [6d 4s 7d] [3s]
casiodk333: bets 400
EXskillance: calls 400
vadim8656: raises 1120 to 1520
casiodk333: folds 
EXskillance said, "99 no good"
EXskillance: folds 
Uncalled bet (1120) returned to vadim8656
vadim8656 collected 1928 from pot
vadim8656: doesn't show hand 
*** SUMMARY ***
Total pot 1928 | Rake 0 
Board [6d 4s 7d 3s]
Seat 1: FrederickH. folded before Flop (didn't bet)
Seat 2: EXskillance folded on the Turn
Seat 3: HaHaUAmateur folded before Flop (didn't bet)
Seat 4: vadim8656 collected (1928)
Seat 5: maXXmilian (button) folded before Flop (didn't bet)
Seat 6: taube1981 (small blind) folded before Flop
Seat 7: casiodk333 (big blind) folded on the Turn
Seat 8: DrimTeam2 folded before Flop (didn't bet)
Seat 9: mossy100 folded before Flop (didn't bet)



PokerStars Hand #132868083494: Tournament #1164585221, $20+$2 USD Hold'em No Limit - Level III (20/40) - 2015/03/29 21:05:10 CET [2015/03/29 15:05:10 ET]
Table '1164585221 156' 9-max Seat #6 is the button
Seat 1: FrederickH. (9999 in chips) 
Seat 2: EXskillance (10780 in chips) 
Seat 3: HaHaUAmateur (10619 in chips) 
Seat 4: vadim8656 (8051 in chips) 
Seat 5: maXXmilian (9682 in chips) 
Seat 6: taube1981 (10939 in chips) 
Seat 7: casiodk333 (8830 in chips) 
Seat 8: DrimTeam2 (9575 in chips) 
Seat 9: mossy100 (11585 in chips) 
casiodk333: posts small blind 20
DrimTeam2: posts big blind 40
*** HOLE CARDS ***
Dealt to casiodk333 [6d Ts]
mossy100: folds 
FrederickH.: raises 80 to 120
EXskillance: folds 
HaHaUAmateur: calls 120
vadim8656: calls 120
maXXmilian: folds 
taube1981: folds 
casiodk333: folds 
DrimTeam2: folds 
*** FLOP *** [2s 5h As]
FrederickH.: bets 280
HaHaUAmateur: calls 280
vadim8656: folds 
*** TURN *** [2s 5h As] [Kc]
FrederickH.: bets 720
HaHaUAmateur: calls 720
*** RIVER *** [2s 5h As Kc] [9h]
FrederickH.: checks 
HaHaUAmateur: checks 
*** SHOW DOWN ***
FrederickH.: shows [Qs Js] (high card Ace)
HaHaUAmateur: shows [Jc Ac] (a pair of Aces)
HaHaUAmateur collected 2420 from pot
*** SUMMARY ***
Total pot 2420 | Rake 0 
Board [2s 5h As Kc 9h]
Seat 1: FrederickH. showed [Qs Js] and lost with high card Ace
Seat 2: EXskillance folded before Flop (didn't bet)
Seat 3: HaHaUAmateur showed [Jc Ac] and won (2420) with a pair of Aces
Seat 4: vadim8656 folded on the Flop
Seat 5: maXXmilian folded before Flop (didn't bet)
Seat 6: taube1981 (button) folded before Flop (didn't bet)
Seat 7: casiodk333 (small blind) folded before Flop
Seat 8: DrimTeam2 (big blind) folded before Flop
Seat 9: mossy100 folded before Flop (didn't bet)



PokerStars Hand #132868235058: Tournament #1164585221, $20+$2 USD Hold'em No Limit - Level III (20/40) - 2015/03/29 21:07:13 CET [2015/03/29 15:07:13 ET]
Table '1164585221 156' 9-max Seat #7 is the button
Seat 1: FrederickH. (8879 in chips) 
Seat 2: EXskillance (10780 in chips) 
Seat 3: HaHaUAmateur (11919 in chips) 
Seat 4: vadim8656 (7931 in chips) 
Seat 5: maXXmilian (9682 in chips) 
Seat 6: taube1981 (10939 in chips) 
Seat 7: casiodk333 (8810 in chips) 
Seat 8: DrimTeam2 (9535 in chips) 
Seat 9: mossy100 (11585 in chips) 
DrimTeam2: posts small blind 20
mossy100: posts big blind 40
*** HOLE CARDS ***
Dealt to casiodk333 [2c 4s]
FrederickH.: folds 
EXskillance: folds 
HaHaUAmateur: raises 60 to 100
vadim8656: folds 
maXXmilian: folds 
taube1981: raises 220 to 320
casiodk333: folds 
DrimTeam2: folds 
mossy100: folds 
HaHaUAmateur: calls 220
*** FLOP *** [Kh 3s Qd]
HaHaUAmateur: checks 
taube1981: bets 1000
HaHaUAmateur: folds 
Uncalled bet (1000) returned to taube1981
taube1981 collected 700 from pot
taube1981: doesn't show hand 
*** SUMMARY ***
Total pot 700 | Rake 0 
Board [Kh 3s Qd]
Seat 1: FrederickH. folded before Flop (didn't bet)
Seat 2: EXskillance folded before Flop (didn't bet)
Seat 3: HaHaUAmateur folded on the Flop
Seat 4: vadim8656 folded before Flop (didn't bet)
Seat 5: maXXmilian folded before Flop (didn't bet)
Seat 6: taube1981 collected (700)
Seat 7: casiodk333 (button) folded before Flop (didn't bet)
Seat 8: DrimTeam2 (small blind) folded before Flop
Seat 9: mossy100 (big blind) folded before Flop



PokerStars Hand #132868322770: Tournament #1164585221, $20+$2 USD Hold'em No Limit - Level III (20/40) - 2015/03/29 21:08:23 CET [2015/03/29 15:08:23 ET]
Table '1164585221 156' 9-max Seat #8 is the button
Seat 1: FrederickH. (8879 in chips) 
Seat 2: EXskillance (10780 in chips) 
Seat 3: HaHaUAmateur (11599 in chips) 
Seat 4: vadim8656 (7931 in chips) 
Seat 5: maXXmilian (9682 in chips) 
Seat 6: taube1981 (11319 in chips) 
Seat 7: casiodk333 (8810 in chips) 
Seat 8: DrimTeam2 (9515 in chips) 
Seat 9: mossy100 (11545 in chips) 
mossy100: posts small blind 20
FrederickH.: posts big blind 40
*** HOLE CARDS ***
Dealt to casiodk333 [3d 2d]
EXskillance: folds 
HaHaUAmateur: folds 
vadim8656: calls 40
maXXmilian: raises 102 to 142
taube1981: folds 
casiodk333: raises 138 to 280
DrimTeam2: folds 
mossy100: folds 
FrederickH.: folds 
vadim8656: calls 240
maXXmilian: calls 138
*** FLOP *** [4h 6d Jd]
vadim8656: checks 
maXXmilian: checks 
casiodk333: bets 567
vadim8656: folds 
maXXmilian: folds 
Uncalled bet (567) returned to casiodk333
casiodk333 collected 900 from pot
*** SUMMARY ***
Total pot 900 | Rake 0 
Board [4h 6d Jd]
Seat 1: FrederickH. (big blind) folded before Flop
Seat 2: EXskillance folded before Flop (didn't bet)
Seat 3: HaHaUAmateur folded before Flop (didn't bet)
Seat 4: vadim8656 folded on the Flop
Seat 5: maXXmilian folded on the Flop
Seat 6: taube1981 folded before Flop (didn't bet)
Seat 7: casiodk333 collected (900)
Seat 8: DrimTeam2 (button) folded before Flop (didn't bet)
Seat 9: mossy100 (small blind) folded before Flop



PokerStars Hand #132868429597: Tournament #1164585221, $20+$2 USD Hold'em No Limit - Level III (20/40) - 2015/03/29 21:09:51 CET [2015/03/29 15:09:51 ET]
Table '1164585221 156' 9-max Seat #9 is the button
Seat 1: FrederickH. (8839 in chips) 
Seat 2: EXskillance (10780 in chips) 
Seat 3: HaHaUAmateur (11599 in chips) 
Seat 4: vadim8656 (7651 in chips) 
Seat 5: maXXmilian (9402 in chips) 
Seat 6: taube1981 (11319 in chips) 
Seat 7: casiodk333 (9430 in chips) 
Seat 8: DrimTeam2 (9515 in chips) 
Seat 9: mossy100 (11525 in chips) 
FrederickH.: posts small blind 20
EXskillance: posts big blind 40
*** HOLE CARDS ***
Dealt to casiodk333 [6s 7c]
HaHaUAmateur: raises 44 to 84
vadim8656: calls 84
maXXmilian: folds 
taube1981: folds 
casiodk333: folds 
DrimTeam2: folds 
mossy100: folds 
FrederickH.: calls 64
EXskillance: folds 
*** FLOP *** [Qc 8s As]
FrederickH.: checks 
HaHaUAmateur: checks 
vadim8656: checks 
*** TURN *** [Qc 8s As] [Kh]
FrederickH.: bets 840
HaHaUAmateur: folds 
vadim8656: folds 
Uncalled bet (840) returned to FrederickH.
FrederickH. collected 292 from pot
FrederickH.: doesn't show hand 
*** SUMMARY ***
Total pot 292 | Rake 0 
Board [Qc 8s As Kh]
Seat 1: FrederickH. (small blind) collected (292)
Seat 2: EXskillance (big blind) folded before Flop
Seat 3: HaHaUAmateur folded on the Turn
Seat 4: vadim8656 folded on the Turn
Seat 5: maXXmilian folded before Flop (didn't bet)
Seat 6: taube1981 folded before Flop (didn't bet)
Seat 7: casiodk333 folded before Flop (didn't bet)
Seat 8: DrimTeam2 folded before Flop (didn't bet)
Seat 9: mossy100 (button) folded before Flop (didn't bet)



PokerStars Hand #132868528326: Tournament #1164585221, $20+$2 USD Hold'em No Limit - Level IV (25/50) - 2015/03/29 21:11:20 CET [2015/03/29 15:11:20 ET]
Table '1164585221 156' 9-max Seat #1 is the button
Seat 1: FrederickH. (9047 in chips) 
Seat 2: EXskillance (10740 in chips) 
Seat 3: HaHaUAmateur (11515 in chips) 
Seat 4: vadim8656 (7567 in chips) 
Seat 5: maXXmilian (9402 in chips) 
Seat 6: taube1981 (11319 in chips) 
Seat 7: casiodk333 (9430 in chips) 
Seat 8: DrimTeam2 (9515 in chips) 
Seat 9: mossy100 (11525 in chips) 
EXskillance: posts small blind 25
HaHaUAmateur: posts big blind 50
*** HOLE CARDS ***
Dealt to casiodk333 [2s 6h]
vadim8656: folds 
maXXmilian: raises 77 to 127
taube1981 has timed out
taube1981: folds 
taube1981 is sitting out
casiodk333: folds 
taube1981 has returned
DrimTeam2: calls 127
mossy100: folds 
FrederickH.: folds 
EXskillance: folds 
HaHaUAmateur: folds 
*** FLOP *** [Td 7c 2d]
maXXmilian: bets 188
DrimTeam2: calls 188
*** TURN *** [Td 7c 2d] [4h]
maXXmilian: bets 420
DrimTeam2: calls 420
*** RIVER *** [Td 7c 2d 4h] [5c]
maXXmilian: checks 
DrimTeam2: checks 
*** SHOW DOWN ***
maXXmilian: shows [Qs Ac] (high card Ace)
DrimTeam2: shows [Ts 9s] (a pair of Tens)
DrimTeam2 collected 1545 from pot
*** SUMMARY ***
Total pot 1545 | Rake 0 
Board [Td 7c 2d 4h 5c]
Seat 1: FrederickH. (button) folded before Flop (didn't bet)
Seat 2: EXskillance (small blind) folded before Flop
Seat 3: HaHaUAmateur (big blind) folded before Flop
Seat 4: vadim8656 folded before Flop (didn't bet)
Seat 5: maXXmilian showed [Qs Ac] and lost with high card Ace
Seat 6: taube1981 folded before Flop (didn't bet)
Seat 7: casiodk333 folded before Flop (didn't bet)
Seat 8: DrimTeam2 showed [Ts 9s] and won (1545) with a pair of Tens
Seat 9: mossy100 folded before Flop (didn't bet)



PokerStars Hand #132868634283: Tournament #1164585221, $20+$2 USD Hold'em No Limit - Level IV (25/50) - 2015/03/29 21:12:52 CET [2015/03/29 15:12:52 ET]
Table '1164585221 156' 9-max Seat #2 is the button
Seat 1: FrederickH. (9047 in chips) 
Seat 2: EXskillance (10715 in chips) 
Seat 3: HaHaUAmateur (11465 in chips) 
Seat 4: vadim8656 (7567 in chips) 
Seat 5: maXXmilian (8667 in chips) 
Seat 6: taube1981 (11319 in chips) 
Seat 7: casiodk333 (9430 in chips) 
Seat 8: DrimTeam2 (10325 in chips) 
Seat 9: mossy100 (11525 in chips) 
HaHaUAmateur: posts small blind 25
vadim8656: posts big blind 50
*** HOLE CARDS ***
Dealt to casiodk333 [Jc 3h]
maXXmilian: folds 
taube1981: folds 
casiodk333: folds 
DrimTeam2: folds 
mossy100: calls 50
FrederickH.: folds 
EXskillance: folds 
HaHaUAmateur: folds 
vadim8656: checks 
*** FLOP *** [3d Js 5h]
vadim8656: checks 
mossy100: bets 125
vadim8656: folds 
Uncalled bet (125) returned to mossy100
mossy100 collected 125 from pot
mossy100: doesn't show hand 
*** SUMMARY ***
Total pot 125 | Rake 0 
Board [3d Js 5h]
Seat 1: FrederickH. folded before Flop (didn't bet)
Seat 2: EXskillance (button) folded before Flop (didn't bet)
Seat 3: HaHaUAmateur (small blind) folded before Flop
Seat 4: vadim8656 (big blind) folded on the Flop
Seat 5: maXXmilian folded before Flop (didn't bet)
Seat 6: taube1981 folded before Flop (didn't bet)
Seat 7: casiodk333 folded before Flop (didn't bet)
Seat 8: DrimTeam2 folded before Flop (didn't bet)
Seat 9: mossy100 collected (125)



PokerStars Hand #132868689887: Tournament #1164585221, $20+$2 USD Hold'em No Limit - Level IV (25/50) - 2015/03/29 21:13:45 CET [2015/03/29 15:13:45 ET]
Table '1164585221 156' 9-max Seat #3 is the button
Seat 1: FrederickH. (9047 in chips) 
Seat 2: EXskillance (10715 in chips) 
Seat 3: HaHaUAmateur (11440 in chips) 
Seat 4: vadim8656 (7517 in chips) 
Seat 5: maXXmilian (8667 in chips) 
Seat 6: taube1981 (11319 in chips) 
Seat 7: casiodk333 (9430 in chips) 
Seat 8: DrimTeam2 (10325 in chips) 
Seat 9: mossy100 (11600 in chips) 
vadim8656: posts small blind 25
maXXmilian: posts big blind 50
*** HOLE CARDS ***
Dealt to casiodk333 [6h Ah]
taube1981: folds 
casiodk333: calls 50
DrimTeam2: folds 
mossy100: folds 
FrederickH.: calls 50
EXskillance: folds 
HaHaUAmateur: folds 
vadim8656: folds 
maXXmilian: checks 
*** FLOP *** [9s 6c Qc]
maXXmilian: checks 
casiodk333: bets 75
FrederickH.: folds 
maXXmilian: calls 75
*** TURN *** [9s 6c Qc] [6s]
maXXmilian: checks 
casiodk333: bets 175
maXXmilian: calls 175
*** RIVER *** [9s 6c Qc 6s] [3h]
maXXmilian: checks 
casiodk333: bets 777
maXXmilian: folds 
Uncalled bet (777) returned to casiodk333
casiodk333 collected 675 from pot
*** SUMMARY ***
Total pot 675 | Rake 0 
Board [9s 6c Qc 6s 3h]
Seat 1: FrederickH. folded on the Flop
Seat 2: EXskillance folded before Flop (didn't bet)
Seat 3: HaHaUAmateur (button) folded before Flop (didn't bet)
Seat 4: vadim8656 (small blind) folded before Flop
Seat 5: maXXmilian (big blind) folded on the River
Seat 6: taube1981 folded before Flop (didn't bet)
Seat 7: casiodk333 collected (675)
Seat 8: DrimTeam2 folded before Flop (didn't bet)
Seat 9: mossy100 folded before Flop (didn't bet)



PokerStars Hand #132868783586: Tournament #1164585221, $20+$2 USD Hold'em No Limit - Level IV (25/50) - 2015/03/29 21:15:05 CET [2015/03/29 15:15:05 ET]
Table '1164585221 156' 9-max Seat #4 is the button
Seat 1: FrederickH. (8997 in chips) 
Seat 2: EXskillance (10715 in chips) 
Seat 3: HaHaUAmateur (11440 in chips) 
Seat 4: vadim8656 (7492 in chips) 
Seat 5: maXXmilian (8367 in chips) 
Seat 6: taube1981 (11319 in chips) 
Seat 7: casiodk333 (9805 in chips) 
Seat 8: DrimTeam2 (10325 in chips) 
Seat 9: mossy100 (11600 in chips) 
maXXmilian: posts small blind 25
taube1981: posts big blind 50
*** HOLE CARDS ***
Dealt to casiodk333 [8c 4c]
casiodk333: folds 
DrimTeam2: folds 
mossy100: folds 
FrederickH.: folds 
EXskillance: folds 
HaHaUAmateur: folds 
vadim8656: calls 50
maXXmilian: calls 25
taube1981: checks 
*** FLOP *** [2s Qc Jc]
maXXmilian: checks 
taube1981: checks 
vadim8656: checks 
*** TURN *** [2s Qc Jc] [2d]
maXXmilian: checks 
taube1981: checks 
vadim8656: checks 
*** RIVER *** [2s Qc Jc 2d] [Qd]
maXXmilian: checks 
taube1981: bets 50
vadim8656: folds 
maXXmilian: folds 
Uncalled bet (50) returned to taube1981
taube1981 collected 150 from pot
taube1981: doesn't show hand 
*** SUMMARY ***
Total pot 150 | Rake 0 
Board [2s Qc Jc 2d Qd]
Seat 1: FrederickH. folded before Flop (didn't bet)
Seat 2: EXskillance folded before Flop (didn't bet)
Seat 3: HaHaUAmateur folded before Flop (didn't bet)
Seat 4: vadim8656 (button) folded on the River
Seat 5: maXXmilian (small blind) folded on the River
Seat 6: taube1981 (big blind) collected (150)
Seat 7: casiodk333 folded before Flop (didn't bet)
Seat 8: DrimTeam2 folded before Flop (didn't bet)
Seat 9: mossy100 folded before Flop (didn't bet)



PokerStars Hand #132868857376: Tournament #1164585221, $20+$2 USD Hold'em No Limit - Level IV (25/50) - 2015/03/29 21:16:11 CET [2015/03/29 15:16:11 ET]
Table '1164585221 156' 9-max Seat #5 is the button
Seat 1: FrederickH. (8997 in chips) 
Seat 2: EXskillance (10715 in chips) 
Seat 3: HaHaUAmateur (11440 in chips) 
Seat 4: vadim8656 (7442 in chips) 
Seat 5: maXXmilian (8317 in chips) 
Seat 6: taube1981 (11419 in chips) 
Seat 7: casiodk333 (9805 in chips) 
Seat 8: DrimTeam2 (10325 in chips) 
Seat 9: mossy100 (11600 in chips) 
taube1981: posts small blind 25
casiodk333: posts big blind 50
*** HOLE CARDS ***
Dealt to casiodk333 [9c 9d]
DrimTeam2: folds 
mossy100: raises 100 to 150
FrederickH.: folds 
EXskillance: folds 
HaHaUAmateur: folds 
vadim8656: folds 
maXXmilian: folds 
taube1981: folds 
casiodk333: calls 100
*** FLOP *** [Qc 7d 2c]
casiodk333: checks 
mossy100: checks 
*** TURN *** [Qc 7d 2c] [8d]
casiodk333: checks 
mossy100: checks 
*** RIVER *** [Qc 7d 2c 8d] [4h]
casiodk333: bets 111
mossy100: folds 
Uncalled bet (111) returned to casiodk333
casiodk333 collected 325 from pot
*** SUMMARY ***
Total pot 325 | Rake 0 
Board [Qc 7d 2c 8d 4h]
Seat 1: FrederickH. folded before Flop (didn't bet)
Seat 2: EXskillance folded before Flop (didn't bet)
Seat 3: HaHaUAmateur folded before Flop (didn't bet)
Seat 4: vadim8656 folded before Flop (didn't bet)
Seat 5: maXXmilian (button) folded before Flop (didn't bet)
Seat 6: taube1981 (small blind) folded before Flop
Seat 7: casiodk333 (big blind) collected (325)
Seat 8: DrimTeam2 folded before Flop (didn't bet)
Seat 9: mossy100 folded on the River



PokerStars Hand #132868962320: Tournament #1164585221, $20+$2 USD Hold'em No Limit - Level IV (25/50) - 2015/03/29 21:17:37 CET [2015/03/29 15:17:37 ET]
Table '1164585221 156' 9-max Seat #6 is the button
Seat 1: FrederickH. (8997 in chips) 
Seat 2: EXskillance (10715 in chips) 
Seat 3: HaHaUAmateur (11440 in chips) 
Seat 4: vadim8656 (7442 in chips) 
Seat 5: maXXmilian (8317 in chips) 
Seat 6: taube1981 (11394 in chips) 
Seat 7: casiodk333 (9980 in chips) 
Seat 8: DrimTeam2 (10325 in chips) 
Seat 9: mossy100 (11450 in chips) 
casiodk333: posts small blind 25
DrimTeam2: posts big blind 50
*** HOLE CARDS ***
Dealt to casiodk333 [3s 7s]
mossy100: folds 
FrederickH.: folds 
EXskillance: folds 
HaHaUAmateur: folds 
vadim8656: calls 50
maXXmilian: calls 50
taube1981: folds 
casiodk333: calls 25
DrimTeam2: checks 
*** FLOP *** [Qc 9h 6d]
casiodk333: checks 
DrimTeam2: bets 200
vadim8656: calls 200
maXXmilian: folds 
casiodk333: folds 
*** TURN *** [Qc 9h 6d] [6s]
DrimTeam2: bets 300
vadim8656: calls 300
*** RIVER *** [Qc 9h 6d 6s] [Kh]
DrimTeam2: checks 
vadim8656: bets 1200
DrimTeam2: folds 
Uncalled bet (1200) returned to vadim8656
vadim8656 collected 1200 from pot
vadim8656: doesn't show hand 
*** SUMMARY ***
Total pot 1200 | Rake 0 
Board [Qc 9h 6d 6s Kh]
Seat 1: FrederickH. folded before Flop (didn't bet)
Seat 2: EXskillance folded before Flop (didn't bet)
Seat 3: HaHaUAmateur folded before Flop (didn't bet)
Seat 4: vadim8656 collected (1200)
Seat 5: maXXmilian folded on the Flop
Seat 6: taube1981 (button) folded before Flop (didn't bet)
Seat 7: casiodk333 (small blind) folded on the Flop
Seat 8: DrimTeam2 (big blind) folded on the River
Seat 9: mossy100 folded before Flop (didn't bet)



PokerStars Hand #132869043548: Tournament #1164585221, $20+$2 USD Hold'em No Limit - Level IV (25/50) - 2015/03/29 21:18:40 CET [2015/03/29 15:18:40 ET]
Table '1164585221 156' 9-max Seat #7 is the button
Seat 1: FrederickH. (8997 in chips) 
Seat 2: EXskillance (10715 in chips) 
Seat 3: HaHaUAmateur (11440 in chips) 
Seat 4: vadim8656 (8092 in chips) 
Seat 5: maXXmilian (8267 in chips) 
Seat 6: taube1981 (11394 in chips) 
Seat 7: casiodk333 (9930 in chips) 
Seat 8: DrimTeam2 (9775 in chips) 
Seat 9: mossy100 (11450 in chips) 
DrimTeam2: posts small blind 25
mossy100: posts big blind 50
*** HOLE CARDS ***
Dealt to casiodk333 [Ac 3s]
FrederickH.: folds 
EXskillance: folds 
HaHaUAmateur: folds 
vadim8656: calls 50
maXXmilian: folds 
taube1981: folds 
casiodk333: calls 50
DrimTeam2: folds 
mossy100: checks 
*** FLOP *** [7d Qd 4d]
mossy100: checks 
vadim8656: checks 
casiodk333: bets 75
mossy100: folds 
vadim8656: calls 75
*** TURN *** [7d Qd 4d] [3h]
vadim8656: checks 
casiodk333: checks 
*** RIVER *** [7d Qd 4d 3h] [6d]
vadim8656: bets 50
casiodk333: folds 
Uncalled bet (50) returned to vadim8656
vadim8656 collected 325 from pot
vadim8656: doesn't show hand 
*** SUMMARY ***
Total pot 325 | Rake 0 
Board [7d Qd 4d 3h 6d]
Seat 1: FrederickH. folded before Flop (didn't bet)
Seat 2: EXskillance folded before Flop (didn't bet)
Seat 3: HaHaUAmateur folded before Flop (didn't bet)
Seat 4: vadim8656 collected (325)
Seat 5: maXXmilian folded before Flop (didn't bet)
Seat 6: taube1981 folded before Flop (didn't bet)
Seat 7: casiodk333 (button) folded on the River
Seat 8: DrimTeam2 (small blind) folded before Flop
Seat 9: mossy100 (big blind) folded on the Flop



PokerStars Hand #132869121530: Tournament #1164585221, $20+$2 USD Hold'em No Limit - Level IV (25/50) - 2015/03/29 21:19:44 CET [2015/03/29 15:19:44 ET]
Table '1164585221 156' 9-max Seat #8 is the button
Seat 1: FrederickH. (8997 in chips) 
Seat 2: EXskillance (10715 in chips) 
Seat 3: HaHaUAmateur (11440 in chips) 
Seat 4: vadim8656 (8292 in chips) 
Seat 5: maXXmilian (8267 in chips) 
Seat 6: taube1981 (11394 in chips) 
Seat 7: casiodk333 (9805 in chips) 
Seat 8: DrimTeam2 (9750 in chips) 
Seat 9: mossy100 (11400 in chips) 
mossy100: posts small blind 25
FrederickH.: posts big blind 50
*** HOLE CARDS ***
Dealt to casiodk333 [2c 7c]
EXskillance: folds 
HaHaUAmateur: raises 100 to 150
vadim8656: folds 
maXXmilian: folds 
taube1981: folds 
casiodk333: calls 150
DrimTeam2: folds 
mossy100: folds 
FrederickH.: folds 
*** FLOP *** [8c 8s Js]
HaHaUAmateur: bets 210
casiodk333: raises 445 to 655
HaHaUAmateur: folds 
Uncalled bet (445) returned to casiodk333
casiodk333 collected 795 from pot
*** SUMMARY ***
Total pot 795 | Rake 0 
Board [8c 8s Js]
Seat 1: FrederickH. (big blind) folded before Flop
Seat 2: EXskillance folded before Flop (didn't bet)
Seat 3: HaHaUAmateur folded on the Flop
Seat 4: vadim8656 folded before Flop (didn't bet)
Seat 5: maXXmilian folded before Flop (didn't bet)
Seat 6: taube1981 folded before Flop (didn't bet)
Seat 7: casiodk333 collected (795)
Seat 8: DrimTeam2 (button) folded before Flop (didn't bet)
Seat 9: mossy100 (small blind) folded before Flop



PokerStars Hand #132869234905: Tournament #1164585221, $20+$2 USD Hold'em No Limit - Level V (30/60) - 2015/03/29 21:21:19 CET [2015/03/29 15:21:19 ET]
Table '1164585221 156' 9-max Seat #9 is the button
Seat 1: FrederickH. (8947 in chips) 
Seat 2: EXskillance (10715 in chips) 
Seat 3: HaHaUAmateur (11080 in chips) 
Seat 4: vadim8656 (8292 in chips) 
Seat 5: maXXmilian (8267 in chips) 
Seat 6: taube1981 (11394 in chips) 
Seat 7: casiodk333 (10240 in chips) 
Seat 8: DrimTeam2 (9750 in chips) 
Seat 9: mossy100 (11375 in chips) 
FrederickH.: posts small blind 30
EXskillance: posts big blind 60
*** HOLE CARDS ***
Dealt to casiodk333 [Qd 6d]
HaHaUAmateur: folds 
vadim8656: raises 60 to 120
maXXmilian: calls 120
taube1981: folds 
casiodk333: folds 
DrimTeam2: folds 
mossy100: folds 
FrederickH.: folds 
EXskillance: folds 
*** FLOP *** [Tc Ts Kd]
vadim8656: bets 165
maXXmilian: calls 165
*** TURN *** [Tc Ts Kd] [Ks]
vadim8656: checks 
maXXmilian: checks 
*** RIVER *** [Tc Ts Kd Ks] [3d]
vadim8656: bets 660
maXXmilian: folds 
Uncalled bet (660) returned to vadim8656
vadim8656 collected 660 from pot
vadim8656: doesn't show hand 
*** SUMMARY ***
Total pot 660 | Rake 0 
Board [Tc Ts Kd Ks 3d]
Seat 1: FrederickH. (small blind) folded before Flop
Seat 2: EXskillance (big blind) folded before Flop
Seat 3: HaHaUAmateur folded before Flop (didn't bet)
Seat 4: vadim8656 collected (660)
Seat 5: maXXmilian folded on the River
Seat 6: taube1981 folded before Flop (didn't bet)
Seat 7: casiodk333 folded before Flop (didn't bet)
Seat 8: DrimTeam2 folded before Flop (didn't bet)
Seat 9: mossy100 (button) folded before Flop (didn't bet)



PokerStars Hand #132869305019: Tournament #1164585221, $20+$2 USD Hold'em No Limit - Level V (30/60) - 2015/03/29 21:22:14 CET [2015/03/29 15:22:14 ET]
Table '1164585221 156' 9-max Seat #1 is the button
Seat 1: FrederickH. (8917 in chips) 
Seat 2: EXskillance (10655 in chips) 
Seat 3: HaHaUAmateur (11080 in chips) 
Seat 4: vadim8656 (8667 in chips) 
Seat 5: maXXmilian (7982 in chips) 
Seat 6: taube1981 (11394 in chips) 
Seat 7: casiodk333 (10240 in chips) 
Seat 8: DrimTeam2 (9750 in chips) 
Seat 9: mossy100 (11375 in chips) 
EXskillance: posts small blind 30
HaHaUAmateur: posts big blind 60
*** HOLE CARDS ***
Dealt to casiodk333 [5d Ac]
vadim8656: folds 
maXXmilian: folds 
taube1981: folds 
casiodk333: folds 
DrimTeam2: folds 
mossy100: raises 150 to 210
FrederickH.: folds 
EXskillance: folds 
HaHaUAmateur: folds 
Uncalled bet (150) returned to mossy100
mossy100 collected 150 from pot
mossy100: doesn't show hand 
*** SUMMARY ***
Total pot 150 | Rake 0 
Seat 1: FrederickH. (button) folded before Flop (didn't bet)
Seat 2: EXskillance (small blind) folded before Flop
Seat 3: HaHaUAmateur (big blind) folded before Flop
Seat 4: vadim8656 folded before Flop (didn't bet)
Seat 5: maXXmilian folded before Flop (didn't bet)
Seat 6: taube1981 folded before Flop (didn't bet)
Seat 7: casiodk333 folded before Flop (didn't bet)
Seat 8: DrimTeam2 folded before Flop (didn't bet)
Seat 9: mossy100 collected (150)



PokerStars Hand #132869406927: Tournament #1164585221, $20+$2 USD Hold'em No Limit - Level V (30/60) - 2015/03/29 21:23:41 CET [2015/03/29 15:23:41 ET]
Table '1164585221 156' 9-max Seat #2 is the button
Seat 1: FrederickH. (8917 in chips) 
Seat 2: EXskillance (10625 in chips) 
Seat 3: HaHaUAmateur (11020 in chips) 
Seat 4: vadim8656 (8667 in chips) 
Seat 5: maXXmilian (7982 in chips) 
Seat 6: taube1981 (11394 in chips) 
Seat 7: casiodk333 (10240 in chips) 
Seat 8: DrimTeam2 (9750 in chips) 
Seat 9: mossy100 (11465 in chips) 
HaHaUAmateur: posts small blind 30
vadim8656: posts big blind 60
*** HOLE CARDS ***
Dealt to casiodk333 [Ts 5d]
maXXmilian: folds 
taube1981: folds 
casiodk333: folds 
DrimTeam2: folds 
mossy100: folds 
FrederickH.: raises 120 to 180
EXskillance: folds 
HaHaUAmateur: folds 
vadim8656: folds 
Uncalled bet (120) returned to FrederickH.
FrederickH. collected 150 from pot
FrederickH.: doesn't show hand 
*** SUMMARY ***
Total pot 150 | Rake 0 
Seat 1: FrederickH. collected (150)
Seat 2: EXskillance (button) folded before Flop (didn't bet)
Seat 3: HaHaUAmateur (small blind) folded before Flop
Seat 4: vadim8656 (big blind) folded before Flop
Seat 5: maXXmilian folded before Flop (didn't bet)
Seat 6: taube1981 folded before Flop (didn't bet)
Seat 7: casiodk333 folded before Flop (didn't bet)
Seat 8: DrimTeam2 folded before Flop (didn't bet)
Seat 9: mossy100 folded before Flop (didn't bet)



PokerStars Hand #132869489529: Tournament #1164585221, $20+$2 USD Hold'em No Limit - Level V (30/60) - 2015/03/29 21:24:54 CET [2015/03/29 15:24:54 ET]
Table '1164585221 156' 9-max Seat #3 is the button
Seat 1: FrederickH. (9007 in chips) 
Seat 2: EXskillance (10625 in chips) 
Seat 3: HaHaUAmateur (10990 in chips) 
Seat 4: vadim8656 (8607 in chips) 
Seat 5: maXXmilian (7982 in chips) 
Seat 6: taube1981 (11394 in chips) 
Seat 7: casiodk333 (10240 in chips) 
Seat 8: DrimTeam2 (9750 in chips) 
Seat 9: mossy100 (11465 in chips) 
vadim8656: posts small blind 30
maXXmilian: posts big blind 60
*** HOLE CARDS ***
Dealt to casiodk333 [5c 3h]
taube1981: folds 
casiodk333: folds 
DrimTeam2: folds 
mossy100: folds 
FrederickH.: folds 
EXskillance: folds 
HaHaUAmateur: raises 66 to 126
vadim8656: folds 
maXXmilian: folds 
Uncalled bet (66) returned to HaHaUAmateur
HaHaUAmateur collected 150 from pot
HaHaUAmateur: doesn't show hand 
*** SUMMARY ***
Total pot 150 | Rake 0 
Seat 1: FrederickH. folded before Flop (didn't bet)
Seat 2: EXskillance folded before Flop (didn't bet)
Seat 3: HaHaUAmateur (button) collected (150)
Seat 4: vadim8656 (small blind) folded before Flop
Seat 5: maXXmilian (big blind) folded before Flop
Seat 6: taube1981 folded before Flop (didn't bet)
Seat 7: casiodk333 folded before Flop (didn't bet)
Seat 8: DrimTeam2 folded before Flop (didn't bet)
Seat 9: mossy100 folded before Flop (didn't bet)



PokerStars Hand #132869565058: Tournament #1164585221, $20+$2 USD Hold'em No Limit - Level V (30/60) - 2015/03/29 21:25:54 CET [2015/03/29 15:25:54 ET]
Table '1164585221 156' 9-max Seat #4 is the button
Seat 1: FrederickH. (9007 in chips) 
Seat 2: EXskillance (10625 in chips) 
Seat 3: HaHaUAmateur (11080 in chips) 
Seat 4: vadim8656 (8577 in chips) 
Seat 5: maXXmilian (7922 in chips) 
Seat 6: taube1981 (11394 in chips) 
Seat 7: casiodk333 (10240 in chips) 
Seat 8: DrimTeam2 (9750 in chips) 
Seat 9: mossy100 (11465 in chips) 
maXXmilian: posts small blind 30
taube1981: posts big blind 60
*** HOLE CARDS ***
Dealt to casiodk333 [Jh 9c]
casiodk333: raises 90 to 150
DrimTeam2: folds 
mossy100: raises 270 to 420
FrederickH.: folds 
EXskillance: folds 
HaHaUAmateur: calls 420
vadim8656 has timed out
vadim8656: folds 
vadim8656 is sitting out
maXXmilian: folds 
vadim8656 has returned
taube1981: raises 1260 to 1680
casiodk333 said, "u boys have fun"
casiodk333: folds 
mossy100: raises 9785 to 11465 and is all-in
HaHaUAmateur: folds 
taube1981: calls 9714 and is all-in
Uncalled bet (71) returned to mossy100
*** FLOP *** [5s 8s 6c]
*** TURN *** [5s 8s 6c] [Qh]
*** RIVER *** [5s 8s 6c Qh] [Tc]
*** SHOW DOWN ***
taube1981: shows [Ks Kh] (a pair of Kings)
mossy100: shows [Ah Ad] (a pair of Aces)
mossy100 collected 23388 from pot
taube1981 finished the tournament in 45758th place
*** SUMMARY ***
Total pot 23388 | Rake 0 
Board [5s 8s 6c Qh Tc]
Seat 1: FrederickH. folded before Flop (didn't bet)
Seat 2: EXskillance folded before Flop (didn't bet)
Seat 3: HaHaUAmateur folded before Flop
Seat 4: vadim8656 (button) folded before Flop (didn't bet)
Seat 5: maXXmilian (small blind) folded before Flop
Seat 6: taube1981 (big blind) showed [Ks Kh] and lost with a pair of Kings
Seat 7: casiodk333 folded before Flop
Seat 8: DrimTeam2 folded before Flop (didn't bet)
Seat 9: mossy100 showed [Ah Ad] and won (23388) with a pair of Aces



PokerStars Hand #132869666076: Tournament #1164585221, $20+$2 USD Hold'em No Limit - Level V (30/60) - 2015/03/29 21:27:32 CET [2015/03/29 15:27:32 ET]
Table '1164585221 156' 9-max Seat #5 is the button
Seat 1: FrederickH. (9007 in chips) 
Seat 2: EXskillance (10625 in chips) 
Seat 3: HaHaUAmateur (10660 in chips) 
Seat 4: vadim8656 (8577 in chips) 
Seat 5: maXXmilian (7892 in chips) 
Seat 6: PayMyBantley (10000 in chips) out of hand (moved from another table into small blind)
Seat 7: casiodk333 (10090 in chips) 
Seat 8: DrimTeam2 (9750 in chips) 
Seat 9: mossy100 (23459 in chips) 
casiodk333: posts small blind 30
DrimTeam2: posts big blind 60
*** HOLE CARDS ***
Dealt to casiodk333 [3h As]
mossy100: folds 
FrederickH.: folds 
EXskillance: folds 
HaHaUAmateur: folds 
vadim8656: calls 60
maXXmilian: raises 153 to 213
casiodk333: folds 
DrimTeam2: folds 
vadim8656: calls 153
*** FLOP *** [Th 5s 5h]
vadim8656: checks 
maXXmilian: bets 246
vadim8656: calls 246
*** TURN *** [Th 5s 5h] [9c]
vadim8656: checks 
maXXmilian: bets 523
vadim8656: raises 1027 to 1550
maXXmilian: folds 
Uncalled bet (1027) returned to vadim8656
vadim8656 collected 2054 from pot
vadim8656: doesn't show hand 
*** SUMMARY ***
Total pot 2054 | Rake 0 
Board [Th 5s 5h 9c]
Seat 1: FrederickH. folded before Flop (didn't bet)
Seat 2: EXskillance folded before Flop (didn't bet)
Seat 3: HaHaUAmateur folded before Flop (didn't bet)
Seat 4: vadim8656 collected (2054)
Seat 5: maXXmilian (button) folded on the Turn
Seat 7: casiodk333 (small blind) folded before Flop
Seat 8: DrimTeam2 (big blind) folded before Flop
Seat 9: mossy100 folded before Flop (didn't bet)



PokerStars Hand #132869750175: Tournament #1164585221, $20+$2 USD Hold'em No Limit - Level V (30/60) - 2015/03/29 21:28:44 CET [2015/03/29 15:28:44 ET]
Table '1164585221 156' 9-max Seat #7 is the button
Seat 1: FrederickH. (9007 in chips) 
Seat 2: EXskillance (10625 in chips) 
Seat 3: HaHaUAmateur (10660 in chips) 
Seat 4: vadim8656 (9649 in chips) 
Seat 5: maXXmilian (6910 in chips) 
Seat 6: PayMyBantley (10000 in chips) 
Seat 7: casiodk333 (10060 in chips) 
Seat 8: DrimTeam2 (9690 in chips) 
Seat 9: mossy100 (23459 in chips) 
DrimTeam2: posts small blind 30
mossy100: posts big blind 60
*** HOLE CARDS ***
Dealt to casiodk333 [As 6h]
FrederickH.: folds 
EXskillance: folds 
HaHaUAmateur: folds 
vadim8656: folds 
maXXmilian: folds 
PayMyBantley: raises 60 to 120
casiodk333: folds 
DrimTeam2: raises 180 to 300
mossy100: folds 
PayMyBantley: calls 180
*** FLOP *** [5s Kc Ah]
DrimTeam2: checks 
PayMyBantley: checks 
*** TURN *** [5s Kc Ah] [4s]
DrimTeam2: bets 300
PayMyBantley: folds 
Uncalled bet (300) returned to DrimTeam2
DrimTeam2 collected 660 from pot
DrimTeam2: doesn't show hand 
*** SUMMARY ***
Total pot 660 | Rake 0 
Board [5s Kc Ah 4s]
Seat 1: FrederickH. folded before Flop (didn't bet)
Seat 2: EXskillance folded before Flop (didn't bet)
Seat 3: HaHaUAmateur folded before Flop (didn't bet)
Seat 4: vadim8656 folded before Flop (didn't bet)
Seat 5: maXXmilian folded before Flop (didn't bet)
Seat 6: PayMyBantley folded on the Turn
Seat 7: casiodk333 (button) folded before Flop (didn't bet)
Seat 8: DrimTeam2 (small blind) collected (660)
Seat 9: mossy100 (big blind) folded before Flop



PokerStars Hand #132869865793: Tournament #1164585221, $20+$2 USD Hold'em No Limit - Level VI (40/80) - 2015/03/29 21:30:32 CET [2015/03/29 15:30:32 ET]
Table '1164585221 156' 9-max Seat #8 is the button
Seat 1: FrederickH. (9007 in chips) 
Seat 2: EXskillance (10625 in chips) 
Seat 3: HaHaUAmateur (10660 in chips) 
Seat 4: vadim8656 (9649 in chips) 
Seat 5: maXXmilian (6910 in chips) 
Seat 6: PayMyBantley (9700 in chips) 
Seat 7: casiodk333 (10060 in chips) 
Seat 8: DrimTeam2 (10050 in chips) 
Seat 9: mossy100 (23399 in chips) 
mossy100: posts small blind 40
FrederickH.: posts big blind 80
*** HOLE CARDS ***
Dealt to casiodk333 [2c 3d]
EXskillance: folds 
HaHaUAmateur: raises 88 to 168
vadim8656: folds 
maXXmilian: folds 
PayMyBantley: folds 
casiodk333: folds 
DrimTeam2: folds 
mossy100: calls 128
FrederickH.: calls 88
*** FLOP *** [7d 7h 4h]
mossy100: checks 
FrederickH.: checks 
HaHaUAmateur: bets 282
mossy100: folds 
FrederickH.: folds 
Uncalled bet (282) returned to HaHaUAmateur
HaHaUAmateur collected 504 from pot
HaHaUAmateur: doesn't show hand 
*** SUMMARY ***
Total pot 504 | Rake 0 
Board [7d 7h 4h]
Seat 1: FrederickH. (big blind) folded on the Flop
Seat 2: EXskillance folded before Flop (didn't bet)
Seat 3: HaHaUAmateur collected (504)
Seat 4: vadim8656 folded before Flop (didn't bet)
Seat 5: maXXmilian folded before Flop (didn't bet)
Seat 6: PayMyBantley folded before Flop (didn't bet)
Seat 7: casiodk333 folded before Flop (didn't bet)
Seat 8: DrimTeam2 (button) folded before Flop (didn't bet)
Seat 9: mossy100 (small blind) folded on the Flop



PokerStars Hand #132870013264: Tournament #1164585221, $20+$2 USD Hold'em No Limit - Level VI (40/80) - 2015/03/29 21:32:36 CET [2015/03/29 15:32:36 ET]
Table '1164585221 156' 9-max Seat #9 is the button
Seat 1: FrederickH. (8839 in chips) 
Seat 2: EXskillance (10625 in chips) 
Seat 3: HaHaUAmateur (10996 in chips) 
Seat 4: vadim8656 (9649 in chips) 
Seat 5: maXXmilian (6910 in chips) 
Seat 6: PayMyBantley (9700 in chips) 
Seat 7: casiodk333 (10060 in chips) 
Seat 8: DrimTeam2 (10050 in chips) 
Seat 9: mossy100 (23231 in chips) 
FrederickH.: posts small blind 40
EXskillance: posts big blind 80
*** HOLE CARDS ***
Dealt to casiodk333 [3s 6s]
HaHaUAmateur: raises 120 to 200
vadim8656: folds 
maXXmilian: folds 
PayMyBantley: folds 
casiodk333: folds 
DrimTeam2: folds 
mossy100: folds 
FrederickH.: folds 
EXskillance: folds 
Uncalled bet (120) returned to HaHaUAmateur
HaHaUAmateur collected 200 from pot
HaHaUAmateur: doesn't show hand 
*** SUMMARY ***
Total pot 200 | Rake 0 
Seat 1: FrederickH. (small blind) folded before Flop
Seat 2: EXskillance (big blind) folded before Flop
Seat 3: HaHaUAmateur collected (200)
Seat 4: vadim8656 folded before Flop (didn't bet)
Seat 5: maXXmilian folded before Flop (didn't bet)
Seat 6: PayMyBantley folded before Flop (didn't bet)
Seat 7: casiodk333 folded before Flop (didn't bet)
Seat 8: DrimTeam2 folded before Flop (didn't bet)
Seat 9: mossy100 (button) folded before Flop (didn't bet)



PokerStars Hand #132870058905: Tournament #1164585221, $20+$2 USD Hold'em No Limit - Level VI (40/80) - 2015/03/29 21:33:12 CET [2015/03/29 15:33:12 ET]
Table '1164585221 156' 9-max Seat #1 is the button
Seat 1: FrederickH. (8799 in chips) 
Seat 2: EXskillance (10545 in chips) 
Seat 3: HaHaUAmateur (11116 in chips) 
Seat 4: vadim8656 (9649 in chips) 
Seat 5: maXXmilian (6910 in chips) 
Seat 6: PayMyBantley (9700 in chips) 
Seat 7: casiodk333 (10060 in chips) 
Seat 8: DrimTeam2 (10050 in chips) 
Seat 9: mossy100 (23231 in chips) 
EXskillance: posts small blind 40
HaHaUAmateur: posts big blind 80
*** HOLE CARDS ***
Dealt to casiodk333 [4s Jh]
vadim8656: folds 
maXXmilian: folds 
PayMyBantley: folds 
casiodk333: folds 
DrimTeam2: folds 
mossy100: folds 
FrederickH.: raises 135 to 215
EXskillance: folds 
HaHaUAmateur: calls 135
*** FLOP *** [Jd 7c Kd]
HaHaUAmateur: checks 
FrederickH.: bets 288
HaHaUAmateur: folds 
Uncalled bet (288) returned to FrederickH.
FrederickH. collected 470 from pot
*** SUMMARY ***
Total pot 470 | Rake 0 
Board [Jd 7c Kd]
Seat 1: FrederickH. (button) collected (470)
Seat 2: EXskillance (small blind) folded before Flop
Seat 3: HaHaUAmateur (big blind) folded on the Flop
Seat 4: vadim8656 folded before Flop (didn't bet)
Seat 5: maXXmilian folded before Flop (didn't bet)
Seat 6: PayMyBantley folded before Flop (didn't bet)
Seat 7: casiodk333 folded before Flop (didn't bet)
Seat 8: DrimTeam2 folded before Flop (didn't bet)
Seat 9: mossy100 folded before Flop (didn't bet)



PokerStars Hand #132870140695: Tournament #1164585221, $20+$2 USD Hold'em No Limit - Level VI (40/80) - 2015/03/29 21:34:21 CET [2015/03/29 15:34:21 ET]
Table '1164585221 156' 9-max Seat #2 is the button
Seat 1: FrederickH. (9054 in chips) 
Seat 2: EXskillance (10505 in chips) 
Seat 3: HaHaUAmateur (10901 in chips) 
Seat 5: maXXmilian (6910 in chips) 
Seat 6: PayMyBantley (9700 in chips) 
Seat 7: casiodk333 (10060 in chips) 
Seat 8: DrimTeam2 (10050 in chips) 
Seat 9: mossy100 (23231 in chips) 
HaHaUAmateur: posts small blind 40
maXXmilian: posts big blind 80
*** HOLE CARDS ***
Dealt to casiodk333 [Ad Ah]
PayMyBantley: folds 
casiodk333: raises 120 to 200
DrimTeam2: folds 
mossy100: folds 
FrederickH.: folds 
EXskillance: folds 
HaHaUAmateur: folds 
maXXmilian: calls 120
*** FLOP *** [Tc 4s 2s]
maXXmilian: checks 
casiodk333: bets 321
maXXmilian: calls 321
*** TURN *** [Tc 4s 2s] [7h]
maXXmilian: checks 
casiodk333: bets 666
maXXmilian: folds 
Uncalled bet (666) returned to casiodk333
casiodk333 collected 1082 from pot
*** SUMMARY ***
Total pot 1082 | Rake 0 
Board [Tc 4s 2s 7h]
Seat 1: FrederickH. folded before Flop (didn't bet)
Seat 2: EXskillance (button) folded before Flop (didn't bet)
Seat 3: HaHaUAmateur (small blind) folded before Flop
Seat 5: maXXmilian (big blind) folded on the Turn
Seat 6: PayMyBantley folded before Flop (didn't bet)
Seat 7: casiodk333 collected (1082)
Seat 8: DrimTeam2 folded before Flop (didn't bet)
Seat 9: mossy100 folded before Flop (didn't bet)



PokerStars Hand #132870264236: Tournament #1164585221, $20+$2 USD Hold'em No Limit - Level VI (40/80) - 2015/03/29 21:36:06 CET [2015/03/29 15:36:06 ET]
Table '1164585221 156' 9-max Seat #3 is the button
Seat 1: FrederickH. (9054 in chips) 
Seat 2: EXskillance (10505 in chips) 
Seat 3: HaHaUAmateur (10861 in chips) 
Seat 4: PunKkKid (10000 in chips) out of hand (moved from another table into small blind)
Seat 5: maXXmilian (6389 in chips) 
Seat 6: PayMyBantley (9700 in chips) 
Seat 7: casiodk333 (10621 in chips) 
Seat 8: DrimTeam2 (10050 in chips) 
Seat 9: mossy100 (23231 in chips) 
maXXmilian: posts small blind 40
PayMyBantley: posts big blind 80
*** HOLE CARDS ***
Dealt to casiodk333 [8s 6s]
casiodk333: raises 80 to 160
DrimTeam2: folds 
mossy100: folds 
FrederickH.: folds 
EXskillance: folds 
HaHaUAmateur: folds 
maXXmilian: folds 
PayMyBantley: folds 
Uncalled bet (80) returned to casiodk333
casiodk333 collected 200 from pot
*** SUMMARY ***
Total pot 200 | Rake 0 
Seat 1: FrederickH. folded before Flop (didn't bet)
Seat 2: EXskillance folded before Flop (didn't bet)
Seat 3: HaHaUAmateur (button) folded before Flop (didn't bet)
Seat 5: maXXmilian (small blind) folded before Flop
Seat 6: PayMyBantley (big blind) folded before Flop
Seat 7: casiodk333 collected (200)
Seat 8: DrimTeam2 folded before Flop (didn't bet)
Seat 9: mossy100 folded before Flop (didn't bet)



PokerStars Hand #132870316559: Tournament #1164585221, $20+$2 USD Hold'em No Limit - Level VI (40/80) - 2015/03/29 21:36:48 CET [2015/03/29 15:36:48 ET]
Table '1164585221 5160' 9-max Seat #1 is the button
Seat 1: struikmat (10000 in chips) 
Seat 2: talendijaht (4698 in chips) 
Seat 3: casiodk333 (10741 in chips) 
Seat 4: Roger321 (6841 in chips) 
Seat 5: JESSE-JMS (5368 in chips) 
Seat 6: S2698 (11881 in chips) 
Seat 7: manthos401 (27500 in chips) 
Seat 8: anjodsk (8853 in chips) 
talendijaht: posts small blind 40
casiodk333: posts big blind 80
*** HOLE CARDS ***
Dealt to casiodk333 [9d 2h]
Roger321 is connected 
Roger321: folds 
JESSE-JMS: raises 160 to 240
S2698: folds 
manthos401 is connected 
manthos401: folds 
anjodsk: folds 
struikmat: folds 
talendijaht: folds 
casiodk333: folds 
Uncalled bet (160) returned to JESSE-JMS
JESSE-JMS collected 200 from pot
JESSE-JMS: doesn't show hand 
*** SUMMARY ***
Total pot 200 | Rake 0 
Seat 1: struikmat (button) folded before Flop (didn't bet)
Seat 2: talendijaht (small blind) folded before Flop
Seat 3: casiodk333 (big blind) folded before Flop
Seat 4: Roger321 folded before Flop (didn't bet)
Seat 5: JESSE-JMS collected (200)
Seat 6: S2698 folded before Flop (didn't bet)
Seat 7: manthos401 folded before Flop (didn't bet)
Seat 8: anjodsk folded before Flop (didn't bet)



PokerStars Hand #132870405337: Tournament #1164585221, $20+$2 USD Hold'em No Limit - Level VI (40/80) - 2015/03/29 21:38:02 CET [2015/03/29 15:38:02 ET]
Table '1164585221 5160' 9-max Seat #2 is the button
Seat 1: struikmat (10000 in chips) 
Seat 2: talendijaht (4658 in chips) 
Seat 3: casiodk333 (10661 in chips) 
Seat 4: Roger321 (6841 in chips) 
Seat 5: JESSE-JMS (5488 in chips) 
Seat 6: S2698 (11881 in chips) 
Seat 7: manthos401 (27500 in chips) 
Seat 8: anjodsk (8853 in chips) 
Seat 9: NINJA 007 PW (10000 in chips) 
casiodk333: posts small blind 40
Roger321: posts big blind 80
*** HOLE CARDS ***
Dealt to casiodk333 [4h Qc]
JESSE-JMS: folds 
S2698: folds 
manthos401: folds 
anjodsk: folds 
NINJA 007 PW: folds 
struikmat: folds 
talendijaht: raises 80 to 160
casiodk333: raises 320 to 480
Roger321: folds 
talendijaht: calls 320
*** FLOP *** [9d 4c Ad]
casiodk333: bets 600
talendijaht: folds 
Uncalled bet (600) returned to casiodk333
casiodk333 collected 1040 from pot
*** SUMMARY ***
Total pot 1040 | Rake 0 
Board [9d 4c Ad]
Seat 1: struikmat folded before Flop (didn't bet)
Seat 2: talendijaht (button) folded on the Flop
Seat 3: casiodk333 (small blind) collected (1040)
Seat 4: Roger321 (big blind) folded before Flop
Seat 5: JESSE-JMS folded before Flop (didn't bet)
Seat 6: S2698 folded before Flop (didn't bet)
Seat 7: manthos401 folded before Flop (didn't bet)
Seat 8: anjodsk folded before Flop (didn't bet)
Seat 9: NINJA 007 PW folded before Flop (didn't bet)



PokerStars Hand #132870563004: Tournament #1164585221, $20+$2 USD Hold'em No Limit - Level VII (50/100) - 2015/03/29 21:40:20 CET [2015/03/29 15:40:20 ET]
Table '1164585221 5160' 9-max Seat #3 is the button
Seat 1: struikmat (10000 in chips) 
Seat 2: talendijaht (4178 in chips) 
Seat 3: casiodk333 (11221 in chips) 
Seat 4: Roger321 (6761 in chips) 
Seat 5: JESSE-JMS (5488 in chips) 
Seat 6: S2698 (11881 in chips) 
Seat 7: manthos401 (27500 in chips) 
Seat 8: anjodsk (8853 in chips) 
Seat 9: NINJA 007 PW (10000 in chips) 
struikmat: posts the ante 10
talendijaht: posts the ante 10
casiodk333: posts the ante 10
Roger321: posts the ante 10
JESSE-JMS: posts the ante 10
S2698: posts the ante 10
manthos401: posts the ante 10
anjodsk: posts the ante 10
NINJA 007 PW: posts the ante 10
Roger321: posts small blind 50
JESSE-JMS: posts big blind 100
*** HOLE CARDS ***
Dealt to casiodk333 [Ts Jh]
S2698: folds 
manthos401: folds 
anjodsk: folds 
NINJA 007 PW: folds 
struikmat: raises 100 to 200
talendijaht: calls 200
casiodk333: calls 200
Roger321: folds 
JESSE-JMS: raises 5278 to 5478 and is all-in
struikmat: folds 
talendijaht: calls 3968 and is all-in
casiodk333: folds 
Uncalled bet (1310) returned to JESSE-JMS
*** FLOP *** [7c Ks Td]
*** TURN *** [7c Ks Td] [5d]
*** RIVER *** [7c Ks Td 5d] [9s]
*** SHOW DOWN ***
JESSE-JMS: shows [Qh As] (high card Ace)
talendijaht: shows [Jc Ah] (high card Ace - lower kicker)
JESSE-JMS collected 8876 from pot
talendijaht is sitting out
*** SUMMARY ***
Total pot 8876 | Rake 0 
Board [7c Ks Td 5d 9s]
Seat 1: struikmat folded before Flop
Seat 2: talendijaht showed [Jc Ah] and lost with high card Ace
Seat 3: casiodk333 (button) folded before Flop
Seat 4: Roger321 (small blind) folded before Flop
Seat 5: JESSE-JMS (big blind) showed [Qh As] and won (8876) with high card Ace
Seat 6: S2698 folded before Flop (didn't bet)
Seat 7: manthos401 folded before Flop (didn't bet)
Seat 8: anjodsk folded before Flop (didn't bet)
Seat 9: NINJA 007 PW folded before Flop (didn't bet)



PokerStars Hand #132870701333: Tournament #1164585221, $20+$2 USD Hold'em No Limit - Level VII (50/100) - 2015/03/29 21:42:20 CET [2015/03/29 15:42:20 ET]
Table '1164585221 5160' 9-max Seat #4 is the button
Seat 1: struikmat (9790 in chips) 
Seat 3: casiodk333 (11011 in chips) 
Seat 4: Roger321 (6701 in chips) 
Seat 5: JESSE-JMS (10186 in chips) 
Seat 6: S2698 (11871 in chips) 
Seat 7: manthos401 (27490 in chips) 
Seat 8: anjodsk (8843 in chips) 
Seat 9: NINJA 007 PW (9990 in chips) 
struikmat: posts the ante 10
casiodk333: posts the ante 10
Roger321: posts the ante 10
JESSE-JMS: posts the ante 10
S2698: posts the ante 10
manthos401: posts the ante 10
anjodsk: posts the ante 10
NINJA 007 PW: posts the ante 10
JESSE-JMS: posts small blind 50
S2698: posts big blind 100
*** HOLE CARDS ***
Dealt to casiodk333 [8d Qh]
manthos401: folds 
anjodsk: folds 
NINJA 007 PW: raises 210 to 310
struikmat: folds 
casiodk333: folds 
Roger321: calls 310
JESSE-JMS: folds 
S2698: folds 
*** FLOP *** [5d 3h 5h]
NINJA 007 PW: checks 
Roger321: bets 425
NINJA 007 PW: folds 
Uncalled bet (425) returned to Roger321
Roger321 collected 850 from pot
Roger321: doesn't show hand 
*** SUMMARY ***
Total pot 850 | Rake 0 
Board [5d 3h 5h]
Seat 1: struikmat folded before Flop (didn't bet)
Seat 3: casiodk333 folded before Flop (didn't bet)
Seat 4: Roger321 (button) collected (850)
Seat 5: JESSE-JMS (small blind) folded before Flop
Seat 6: S2698 (big blind) folded before Flop
Seat 7: manthos401 folded before Flop (didn't bet)
Seat 8: anjodsk folded before Flop (didn't bet)
Seat 9: NINJA 007 PW folded on the Flop



PokerStars Hand #132870798514: Tournament #1164585221, $20+$2 USD Hold'em No Limit - Level VII (50/100) - 2015/03/29 21:43:41 CET [2015/03/29 15:43:41 ET]
Table '1164585221 5160' 9-max Seat #5 is the button
Seat 1: struikmat (9780 in chips) 
Seat 2: grangala909 (10000 in chips) 
Seat 3: casiodk333 (11001 in chips) 
Seat 4: Roger321 (7231 in chips) 
Seat 5: JESSE-JMS (10126 in chips) 
Seat 6: S2698 (11761 in chips) 
Seat 7: manthos401 (27480 in chips) 
Seat 8: anjodsk (8833 in chips) 
Seat 9: NINJA 007 PW (9670 in chips) 
struikmat: posts the ante 10
grangala909: posts the ante 10
casiodk333: posts the ante 10
Roger321: posts the ante 10
JESSE-JMS: posts the ante 10
S2698: posts the ante 10
manthos401: posts the ante 10
anjodsk: posts the ante 10
NINJA 007 PW: posts the ante 10
S2698: posts small blind 50
manthos401: posts big blind 100
*** HOLE CARDS ***
Dealt to casiodk333 [5d Ac]
anjodsk: folds 
NINJA 007 PW: folds 
struikmat: folds 
grangala909: folds 
casiodk333: folds 
Roger321: raises 100 to 200
JESSE-JMS: folds 
S2698: folds 
manthos401: calls 100
*** FLOP *** [5s 5c 8d]
manthos401: checks 
Roger321: bets 300
manthos401: raises 400 to 700
Roger321: calls 400
*** TURN *** [5s 5c 8d] [Td]
manthos401: bets 1000
Roger321: calls 1000
*** RIVER *** [5s 5c 8d Td] [2s]
manthos401: checks 
Roger321: checks 
*** SHOW DOWN ***
manthos401: shows [6c 6d] (two pair, Sixes and Fives)
Roger321: shows [Js Jd] (two pair, Jacks and Fives)
Roger321 collected 3940 from pot
*** SUMMARY ***
Total pot 3940 | Rake 0 
Board [5s 5c 8d Td 2s]
Seat 1: struikmat folded before Flop (didn't bet)
Seat 2: grangala909 folded before Flop (didn't bet)
Seat 3: casiodk333 folded before Flop (didn't bet)
Seat 4: Roger321 showed [Js Jd] and won (3940) with two pair, Jacks and Fives
Seat 5: JESSE-JMS (button) folded before Flop (didn't bet)
Seat 6: S2698 (small blind) folded before Flop
Seat 7: manthos401 (big blind) showed [6c 6d] and lost with two pair, Sixes and Fives
Seat 8: anjodsk folded before Flop (didn't bet)
Seat 9: NINJA 007 PW folded before Flop (didn't bet)



PokerStars Hand #132870914733: Tournament #1164585221, $20+$2 USD Hold'em No Limit - Level VII (50/100) - 2015/03/29 21:45:15 CET [2015/03/29 15:45:15 ET]
Table '1164585221 5160' 9-max Seat #6 is the button
Seat 1: struikmat (9770 in chips) 
Seat 2: grangala909 (9990 in chips) 
Seat 3: casiodk333 (10991 in chips) 
Seat 4: Roger321 (9261 in chips) 
Seat 5: JESSE-JMS (10116 in chips) 
Seat 6: S2698 (11701 in chips) 
Seat 7: manthos401 (25570 in chips) 
Seat 8: anjodsk (8823 in chips) 
Seat 9: NINJA 007 PW (9660 in chips) 
struikmat: posts the ante 10
grangala909: posts the ante 10
casiodk333: posts the ante 10
Roger321: posts the ante 10
JESSE-JMS: posts the ante 10
S2698: posts the ante 10
manthos401: posts the ante 10
anjodsk: posts the ante 10
NINJA 007 PW: posts the ante 10
manthos401: posts small blind 50
anjodsk: posts big blind 100
*** HOLE CARDS ***
Dealt to casiodk333 [4h 8h]
NINJA 007 PW: folds 
struikmat: folds 
grangala909: calls 100
casiodk333: raises 200 to 300
Roger321: raises 500 to 800
JESSE-JMS: folds 
S2698: folds 
manthos401: folds 
anjodsk: folds 
grangala909: folds 
casiodk333: calls 500
*** FLOP *** [2h 9d Qh]
casiodk333: bets 777
Roger321: folds 
Uncalled bet (777) returned to casiodk333
casiodk333 collected 1940 from pot
*** SUMMARY ***
Total pot 1940 | Rake 0 
Board [2h 9d Qh]
Seat 1: struikmat folded before Flop (didn't bet)
Seat 2: grangala909 folded before Flop
Seat 3: casiodk333 collected (1940)
Seat 4: Roger321 folded on the Flop
Seat 5: JESSE-JMS folded before Flop (didn't bet)
Seat 6: S2698 (button) folded before Flop (didn't bet)
Seat 7: manthos401 (small blind) folded before Flop
Seat 8: anjodsk (big blind) folded before Flop
Seat 9: NINJA 007 PW folded before Flop (didn't bet)



PokerStars Hand #132871021193: Tournament #1164585221, $20+$2 USD Hold'em No Limit - Level VII (50/100) - 2015/03/29 21:46:44 CET [2015/03/29 15:46:44 ET]
Table '1164585221 5160' 9-max Seat #7 is the button
Seat 1: struikmat (9760 in chips) 
Seat 2: grangala909 (9880 in chips) 
Seat 3: casiodk333 (12121 in chips) 
Seat 4: Roger321 (8451 in chips) 
Seat 5: JESSE-JMS (10106 in chips) 
Seat 6: S2698 (11691 in chips) 
Seat 7: manthos401 (25510 in chips) 
Seat 8: anjodsk (8713 in chips) 
Seat 9: NINJA 007 PW (9650 in chips) 
struikmat: posts the ante 10
grangala909: posts the ante 10
casiodk333: posts the ante 10
Roger321: posts the ante 10
JESSE-JMS: posts the ante 10
S2698: posts the ante 10
manthos401: posts the ante 10
anjodsk: posts the ante 10
NINJA 007 PW: posts the ante 10
anjodsk: posts small blind 50
NINJA 007 PW: posts big blind 100
*** HOLE CARDS ***
Dealt to casiodk333 [Jd Ah]
struikmat: folds 
grangala909: calls 100
casiodk333: calls 100
Roger321: raises 300 to 400
JESSE-JMS: folds 
S2698: folds 
manthos401: folds 
anjodsk: folds 
NINJA 007 PW: folds 
grangala909: calls 300
casiodk333: calls 300
*** FLOP *** [Qh Kd 9h]
grangala909: checks 
casiodk333: checks 
Roger321: bets 720
grangala909: folds 
casiodk333: calls 720
*** TURN *** [Qh Kd 9h] [9s]
casiodk333: checks 
Roger321: bets 1600
casiodk333: folds 
Uncalled bet (1600) returned to Roger321
Roger321 collected 2880 from pot
Roger321: doesn't show hand 
*** SUMMARY ***
Total pot 2880 | Rake 0 
Board [Qh Kd 9h 9s]
Seat 1: struikmat folded before Flop (didn't bet)
Seat 2: grangala909 folded on the Flop
Seat 3: casiodk333 folded on the Turn
Seat 4: Roger321 collected (2880)
Seat 5: JESSE-JMS folded before Flop (didn't bet)
Seat 6: S2698 folded before Flop (didn't bet)
Seat 7: manthos401 (button) folded before Flop (didn't bet)
Seat 8: anjodsk (small blind) folded before Flop
Seat 9: NINJA 007 PW (big blind) folded before Flop



PokerStars Hand #132871148533: Tournament #1164585221, $20+$2 USD Hold'em No Limit - Level VII (50/100) - 2015/03/29 21:48:28 CET [2015/03/29 15:48:28 ET]
Table '1164585221 5160' 9-max Seat #8 is the button
Seat 1: struikmat (9750 in chips) 
Seat 2: grangala909 (9470 in chips) 
Seat 3: casiodk333 (10991 in chips) 
Seat 4: Roger321 (10201 in chips) 
Seat 5: JESSE-JMS (10096 in chips) 
Seat 6: S2698 (11681 in chips) 
Seat 7: manthos401 (25500 in chips) 
Seat 8: anjodsk (8653 in chips) 
Seat 9: NINJA 007 PW (9540 in chips) 
struikmat: posts the ante 10
grangala909: posts the ante 10
casiodk333: posts the ante 10
Roger321: posts the ante 10
JESSE-JMS: posts the ante 10
S2698: posts the ante 10
manthos401: posts the ante 10
anjodsk: posts the ante 10
NINJA 007 PW: posts the ante 10
NINJA 007 PW: posts small blind 50
struikmat: posts big blind 100
*** HOLE CARDS ***
Dealt to casiodk333 [Qc 6h]
grangala909: folds 
casiodk333: folds 
Roger321: folds 
JESSE-JMS: folds 
S2698: calls 100
manthos401: folds 
anjodsk: raises 150 to 250
NINJA 007 PW: folds 
struikmat: calls 150
S2698: calls 150
*** FLOP *** [4d 3h As]
struikmat: checks 
S2698: checks 
anjodsk: checks 
*** TURN *** [4d 3h As] [Tc]
struikmat: checks 
S2698: checks 
anjodsk: bets 500
struikmat: folds 
S2698: folds 
Uncalled bet (500) returned to anjodsk
anjodsk collected 890 from pot
anjodsk: doesn't show hand 
*** SUMMARY ***
Total pot 890 | Rake 0 
Board [4d 3h As Tc]
Seat 1: struikmat (big blind) folded on the Turn
Seat 2: grangala909 folded before Flop (didn't bet)
Seat 3: casiodk333 folded before Flop (didn't bet)
Seat 4: Roger321 folded before Flop (didn't bet)
Seat 5: JESSE-JMS folded before Flop (didn't bet)
Seat 6: S2698 folded on the Turn
Seat 7: manthos401 folded before Flop (didn't bet)
Seat 8: anjodsk (button) collected (890)
Seat 9: NINJA 007 PW (small blind) folded before Flop



PokerStars Hand #132871268658: Tournament #1164585221, $20+$2 USD Hold'em No Limit - Level VII (50/100) - 2015/03/29 21:50:05 CET [2015/03/29 15:50:05 ET]
Table '1164585221 5160' 9-max Seat #9 is the button
Seat 1: struikmat (9490 in chips) 
Seat 2: grangala909 (9460 in chips) 
Seat 3: casiodk333 (10981 in chips) 
Seat 4: Roger321 (10191 in chips) 
Seat 5: JESSE-JMS (10086 in chips) 
Seat 6: S2698 (11421 in chips) 
Seat 7: manthos401 (25490 in chips) 
Seat 8: anjodsk (9283 in chips) 
Seat 9: NINJA 007 PW (9480 in chips) 
struikmat: posts the ante 10
grangala909: posts the ante 10
casiodk333: posts the ante 10
Roger321: posts the ante 10
JESSE-JMS: posts the ante 10
S2698: posts the ante 10
manthos401: posts the ante 10
anjodsk: posts the ante 10
NINJA 007 PW: posts the ante 10
struikmat: posts small blind 50
grangala909: posts big blind 100
*** HOLE CARDS ***
Dealt to casiodk333 [7c Tc]
casiodk333: folds 
Roger321: folds 
JESSE-JMS: folds 
S2698: calls 100
manthos401: raises 200 to 300
anjodsk: folds 
NINJA 007 PW: folds 
struikmat: folds 
grangala909: calls 200
S2698: calls 200
*** FLOP *** [7h 3s Qs]
grangala909: checks 
S2698: checks 
manthos401: bets 500
grangala909: folds 
S2698: calls 500
*** TURN *** [7h 3s Qs] [As]
S2698: checks 
manthos401: checks 
*** RIVER *** [7h 3s Qs As] [Qd]
S2698: bets 1050
manthos401: calls 1050
*** SHOW DOWN ***
S2698: shows [3h 3c] (a full house, Threes full of Queens)
manthos401: mucks hand 
S2698 collected 4140 from pot
*** SUMMARY ***
Total pot 4140 | Rake 0 
Board [7h 3s Qs As Qd]
Seat 1: struikmat (small blind) folded before Flop
Seat 2: grangala909 (big blind) folded on the Flop
Seat 3: casiodk333 folded before Flop (didn't bet)
Seat 4: Roger321 folded before Flop (didn't bet)
Seat 5: JESSE-JMS folded before Flop (didn't bet)
Seat 6: S2698 showed [3h 3c] and won (4140) with a full house, Threes full of Queens
Seat 7: manthos401 mucked [6c Qc]
Seat 8: anjodsk folded before Flop (didn't bet)
Seat 9: NINJA 007 PW (button) folded before Flop (didn't bet)



PokerStars Hand #132871396919: Tournament #1164585221, $20+$2 USD Hold'em No Limit - Level VIII (60/120) - 2015/03/29 21:51:54 CET [2015/03/29 15:51:54 ET]
Table '1164585221 5160' 9-max Seat #1 is the button
Seat 1: struikmat (9430 in chips) 
Seat 2: grangala909 (9150 in chips) 
Seat 3: casiodk333 (10971 in chips) 
Seat 4: Roger321 (10181 in chips) 
Seat 5: JESSE-JMS (10076 in chips) 
Seat 6: S2698 (13701 in chips) 
Seat 7: manthos401 (23630 in chips) 
Seat 8: anjodsk (9273 in chips) 
Seat 9: NINJA 007 PW (9470 in chips) 
struikmat: posts the ante 15
grangala909: posts the ante 15
casiodk333: posts the ante 15
Roger321: posts the ante 15
JESSE-JMS: posts the ante 15
S2698: posts the ante 15
manthos401: posts the ante 15
anjodsk: posts the ante 15
NINJA 007 PW: posts the ante 15
grangala909: posts small blind 60
casiodk333: posts big blind 120
*** HOLE CARDS ***
Dealt to casiodk333 [6c 6s]
Roger321: raises 120 to 240
JESSE-JMS: calls 240
S2698: folds 
manthos401: folds 
anjodsk: calls 240
NINJA 007 PW: raises 600 to 840
struikmat: folds 
grangala909: folds 
casiodk333: folds 
Roger321: calls 600
JESSE-JMS: raises 9221 to 10061 and is all-in
anjodsk: folds 
NINJA 007 PW: folds 
Roger321: folds 
Uncalled bet (9221) returned to JESSE-JMS
JESSE-JMS collected 3075 from pot
JESSE-JMS: doesn't show hand 
*** SUMMARY ***
Total pot 3075 | Rake 0 
Seat 1: struikmat (button) folded before Flop (didn't bet)
Seat 2: grangala909 (small blind) folded before Flop
Seat 3: casiodk333 (big blind) folded before Flop
Seat 4: Roger321 folded before Flop
Seat 5: JESSE-JMS collected (3075)
Seat 6: S2698 folded before Flop (didn't bet)
Seat 7: manthos401 folded before Flop (didn't bet)
Seat 8: anjodsk folded before Flop
Seat 9: NINJA 007 PW folded before Flop



PokerStars Hand #132871513892: Tournament #1164585221, $20+$2 USD Hold'em No Limit - Level VIII (60/120) - 2015/03/29 21:53:36 CET [2015/03/29 15:53:36 ET]
Table '1164585221 5160' 9-max Seat #2 is the button
Seat 1: struikmat (9415 in chips) 
Seat 2: grangala909 (9075 in chips) 
Seat 3: casiodk333 (10836 in chips) 
Seat 4: Roger321 (9326 in chips) 
Seat 5: JESSE-JMS (12296 in chips) 
Seat 6: S2698 (13686 in chips) 
Seat 7: manthos401 (23615 in chips) 
Seat 8: anjodsk (9018 in chips) 
Seat 9: NINJA 007 PW (8615 in chips) 
struikmat: posts the ante 15
grangala909: posts the ante 15
casiodk333: posts the ante 15
Roger321: posts the ante 15
JESSE-JMS: posts the ante 15
S2698: posts the ante 15
manthos401: posts the ante 15
anjodsk: posts the ante 15
NINJA 007 PW: posts the ante 15
casiodk333: posts small blind 60
Roger321: posts big blind 120
*** HOLE CARDS ***
Dealt to casiodk333 [Jd 6c]
JESSE-JMS: folds 
S2698: raises 240 to 360
manthos401: folds 
anjodsk: folds 
NINJA 007 PW: folds 
struikmat: calls 360
grangala909: calls 360
casiodk333: folds 
Roger321: folds 
*** FLOP *** [9c 2c 7d]
S2698: checks 
struikmat: checks 
grangala909: checks 
*** TURN *** [9c 2c 7d] [9h]
S2698: bets 180
struikmat: calls 180
grangala909: calls 180
*** RIVER *** [9c 2c 7d 9h] [8d]
S2698: bets 240
struikmat: calls 240
grangala909: folds 
*** SHOW DOWN ***
S2698: shows [Kd As] (a pair of Nines)
struikmat: mucks hand 
S2698 collected 2415 from pot
*** SUMMARY ***
Total pot 2415 | Rake 0 
Board [9c 2c 7d 9h 8d]
Seat 1: struikmat mucked [Qc Ad]
Seat 2: grangala909 (button) folded on the River
Seat 3: casiodk333 (small blind) folded before Flop
Seat 4: Roger321 (big blind) folded before Flop
Seat 5: JESSE-JMS folded before Flop (didn't bet)
Seat 6: S2698 showed [Kd As] and won (2415) with a pair of Nines
Seat 7: manthos401 folded before Flop (didn't bet)
Seat 8: anjodsk folded before Flop (didn't bet)
Seat 9: NINJA 007 PW folded before Flop (didn't bet)



PokerStars Hand #132871599434: Tournament #1164585221, $20+$2 USD Hold'em No Limit - Level VIII (60/120) - 2015/03/29 21:54:48 CET [2015/03/29 15:54:48 ET]
Table '1164585221 5160' 9-max Seat #3 is the button
Seat 1: struikmat (8620 in chips) 
Seat 2: grangala909 (8520 in chips) 
Seat 3: casiodk333 (10761 in chips) 
Seat 4: Roger321 (9191 in chips) 
Seat 5: JESSE-JMS (12281 in chips) 
Seat 6: S2698 (15306 in chips) 
Seat 7: manthos401 (23600 in chips) 
Seat 8: anjodsk (9003 in chips) 
Seat 9: NINJA 007 PW (8600 in chips) 
struikmat: posts the ante 15
grangala909: posts the ante 15
casiodk333: posts the ante 15
Roger321: posts the ante 15
JESSE-JMS: posts the ante 15
S2698: posts the ante 15
manthos401: posts the ante 15
anjodsk: posts the ante 15
NINJA 007 PW: posts the ante 15
Roger321: posts small blind 60
JESSE-JMS: posts big blind 120
*** HOLE CARDS ***
Dealt to casiodk333 [4h 6h]
S2698: raises 180 to 300
manthos401: calls 300
anjodsk: folds 
NINJA 007 PW: folds 
struikmat: folds 
grangala909: folds 
casiodk333: calls 300
Roger321: folds 
JESSE-JMS: raises 660 to 960
S2698: calls 660
manthos401: folds 
casiodk333: calls 660
*** FLOP *** [4d 9s 3d]
JESSE-JMS: bets 1440
S2698: folds 
casiodk333: calls 1440
*** TURN *** [4d 9s 3d] [Ts]
JESSE-JMS: checks 
casiodk333: checks 
*** RIVER *** [4d 9s 3d Ts] [Th]
JESSE-JMS: bets 6255
casiodk333: folds 
Uncalled bet (6255) returned to JESSE-JMS
JESSE-JMS collected 6255 from pot
JESSE-JMS: doesn't show hand 
*** SUMMARY ***
Total pot 6255 | Rake 0 
Board [4d 9s 3d Ts Th]
Seat 1: struikmat folded before Flop (didn't bet)
Seat 2: grangala909 folded before Flop (didn't bet)
Seat 3: casiodk333 (button) folded on the River
Seat 4: Roger321 (small blind) folded before Flop
Seat 5: JESSE-JMS (big blind) collected (6255)
Seat 6: S2698 folded on the Flop
Seat 7: manthos401 folded before Flop
Seat 8: anjodsk folded before Flop (didn't bet)
Seat 9: NINJA 007 PW folded before Flop (didn't bet)



PokerStars Hand #132872259244: Tournament #1164585221, $20+$2 USD Hold'em No Limit - Level VIII (60/120) - 2015/03/29 22:06:10 CET [2015/03/29 16:06:10 ET]
Table '1164585221 5160' 9-max Seat #4 is the button
Seat 1: struikmat (8605 in chips) 
Seat 2: grangala909 (8505 in chips) 
Seat 3: casiodk333 (8346 in chips) 
Seat 4: Roger321 (9116 in chips) 
Seat 5: JESSE-JMS (16121 in chips) 
Seat 6: S2698 (14331 in chips) 
Seat 7: manthos401 (23285 in chips) 
Seat 8: anjodsk (8988 in chips) 
Seat 9: NINJA 007 PW (8585 in chips) 
struikmat: posts the ante 15
grangala909: posts the ante 15
casiodk333: posts the ante 15
Roger321: posts the ante 15
JESSE-JMS: posts the ante 15
S2698: posts the ante 15
manthos401: posts the ante 15
anjodsk: posts the ante 15
NINJA 007 PW: posts the ante 15
JESSE-JMS: posts small blind 60
S2698: posts big blind 120
*** HOLE CARDS ***
Dealt to casiodk333 [9d 3s]
manthos401: calls 120
anjodsk: folds 
NINJA 007 PW: folds 
struikmat: folds 
grangala909: folds 
casiodk333: folds 
Roger321: folds 
JESSE-JMS: calls 60
S2698: checks 
*** FLOP *** [2c Ah 3c]
JESSE-JMS: checks 
S2698: checks 
manthos401: bets 240
JESSE-JMS: folds 
S2698: folds 
Uncalled bet (240) returned to manthos401
manthos401 collected 495 from pot
manthos401: doesn't show hand 
*** SUMMARY ***
Total pot 495 | Rake 0 
Board [2c Ah 3c]
Seat 1: struikmat folded before Flop (didn't bet)
Seat 2: grangala909 folded before Flop (didn't bet)
Seat 3: casiodk333 folded before Flop (didn't bet)
Seat 4: Roger321 (button) folded before Flop (didn't bet)
Seat 5: JESSE-JMS (small blind) folded on the Flop
Seat 6: S2698 (big blind) folded on the Flop
Seat 7: manthos401 collected (495)
Seat 8: anjodsk folded before Flop (didn't bet)
Seat 9: NINJA 007 PW folded before Flop (didn't bet)



PokerStars Hand #132872325908: Tournament #1164585221, $20+$2 USD Hold'em No Limit - Level VIII (60/120) - 2015/03/29 22:07:01 CET [2015/03/29 16:07:01 ET]
Table '1164585221 5160' 9-max Seat #5 is the button
Seat 1: struikmat (8590 in chips) 
Seat 2: grangala909 (8490 in chips) 
Seat 3: casiodk333 (8331 in chips) 
Seat 4: Roger321 (9101 in chips) 
Seat 5: JESSE-JMS (15986 in chips) 
Seat 6: S2698 (14196 in chips) 
Seat 7: manthos401 (23645 in chips) 
Seat 8: anjodsk (8973 in chips) 
Seat 9: NINJA 007 PW (8570 in chips) 
struikmat: posts the ante 15
grangala909: posts the ante 15
casiodk333: posts the ante 15
Roger321: posts the ante 15
JESSE-JMS: posts the ante 15
S2698: posts the ante 15
manthos401: posts the ante 15
anjodsk: posts the ante 15
NINJA 007 PW: posts the ante 15
S2698: posts small blind 60
manthos401: posts big blind 120
*** HOLE CARDS ***
Dealt to casiodk333 [Ts 4d]
anjodsk: folds 
NINJA 007 PW: folds 
struikmat: folds 
grangala909: folds 
casiodk333: folds 
Roger321: folds 
JESSE-JMS: raises 240 to 360
S2698: folds 
manthos401: folds 
Uncalled bet (240) returned to JESSE-JMS
JESSE-JMS collected 435 from pot
JESSE-JMS: doesn't show hand 
*** SUMMARY ***
Total pot 435 | Rake 0 
Seat 1: struikmat folded before Flop (didn't bet)
Seat 2: grangala909 folded before Flop (didn't bet)
Seat 3: casiodk333 folded before Flop (didn't bet)
Seat 4: Roger321 folded before Flop (didn't bet)
Seat 5: JESSE-JMS (button) collected (435)
Seat 6: S2698 (small blind) folded before Flop
Seat 7: manthos401 (big blind) folded before Flop
Seat 8: anjodsk folded before Flop (didn't bet)
Seat 9: NINJA 007 PW folded before Flop (didn't bet)



PokerStars Hand #132872388617: Tournament #1164585221, $20+$2 USD Hold'em No Limit - Level VIII (60/120) - 2015/03/29 22:07:50 CET [2015/03/29 16:07:50 ET]
Table '1164585221 5160' 9-max Seat #6 is the button
Seat 1: struikmat (8575 in chips) 
Seat 2: grangala909 (8475 in chips) 
Seat 3: casiodk333 (8316 in chips) 
Seat 4: Roger321 (9086 in chips) 
Seat 5: JESSE-JMS (16286 in chips) 
Seat 6: S2698 (14121 in chips) 
Seat 7: manthos401 (23510 in chips) 
Seat 8: anjodsk (8958 in chips) 
Seat 9: NINJA 007 PW (8555 in chips) 
struikmat: posts the ante 15
grangala909: posts the ante 15
casiodk333: posts the ante 15
Roger321: posts the ante 15
JESSE-JMS: posts the ante 15
S2698: posts the ante 15
manthos401: posts the ante 15
anjodsk: posts the ante 15
NINJA 007 PW: posts the ante 15
manthos401: posts small blind 60
anjodsk: posts big blind 120
*** HOLE CARDS ***
Dealt to casiodk333 [5d 2s]
NINJA 007 PW: folds 
struikmat: folds 
grangala909: raises 120 to 240
casiodk333: folds 
Roger321: folds 
JESSE-JMS: folds 
S2698: folds 
manthos401: calls 180
anjodsk: calls 120
*** FLOP *** [Ts Qh 3h]
manthos401: checks 
anjodsk: checks 
grangala909: bets 360
manthos401: calls 360
anjodsk: folds 
*** TURN *** [Ts Qh 3h] [6d]
manthos401: bets 840
grangala909: raises 960 to 1800
manthos401: calls 960
*** RIVER *** [Ts Qh 3h 6d] [Jd]
manthos401: checks 
grangala909: bets 1800
manthos401: raises 2280 to 4080
grangala909: folds 
Uncalled bet (2280) returned to manthos401
manthos401 collected 8775 from pot
manthos401: doesn't show hand 
*** SUMMARY ***
Total pot 8775 | Rake 0 
Board [Ts Qh 3h 6d Jd]
Seat 1: struikmat folded before Flop (didn't bet)
Seat 2: grangala909 folded on the River
Seat 3: casiodk333 folded before Flop (didn't bet)
Seat 4: Roger321 folded before Flop (didn't bet)
Seat 5: JESSE-JMS folded before Flop (didn't bet)
Seat 6: S2698 (button) folded before Flop (didn't bet)
Seat 7: manthos401 (small blind) collected (8775)
Seat 8: anjodsk (big blind) folded on the Flop
Seat 9: NINJA 007 PW folded before Flop (didn't bet)



PokerStars Hand #132872513042: Tournament #1164585221, $20+$2 USD Hold'em No Limit - Level VIII (60/120) - 2015/03/29 22:09:29 CET [2015/03/29 16:09:29 ET]
Table '1164585221 5160' 9-max Seat #7 is the button
Seat 1: struikmat (8560 in chips) 
Seat 2: grangala909 (4260 in chips) 
Seat 3: casiodk333 (8301 in chips) 
Seat 4: Roger321 (9071 in chips) 
Seat 5: JESSE-JMS (16271 in chips) 
Seat 6: S2698 (14106 in chips) 
Seat 7: manthos401 (28070 in chips) 
Seat 8: anjodsk (8703 in chips) 
Seat 9: NINJA 007 PW (8540 in chips) 
struikmat: posts the ante 15
grangala909: posts the ante 15
casiodk333: posts the ante 15
Roger321: posts the ante 15
JESSE-JMS: posts the ante 15
S2698: posts the ante 15
manthos401: posts the ante 15
anjodsk: posts the ante 15
NINJA 007 PW: posts the ante 15
anjodsk: posts small blind 60
NINJA 007 PW: posts big blind 120
*** HOLE CARDS ***
Dealt to casiodk333 [Qs Td]
struikmat: folds 
grangala909: raises 120 to 240
casiodk333: calls 240
Roger321: calls 240
JESSE-JMS: folds 
S2698: folds 
manthos401: folds 
anjodsk: folds 
NINJA 007 PW: calls 120
*** FLOP *** [Jc 4s 8d]
NINJA 007 PW: checks 
grangala909: bets 360
casiodk333: calls 360
Roger321: calls 360
NINJA 007 PW: folds 
*** TURN *** [Jc 4s 8d] [7s]
grangala909: bets 1080
casiodk333: calls 1080
Roger321: folds 
*** RIVER *** [Jc 4s 8d 7s] [As]
grangala909: bets 2565 and is all-in
casiodk333: folds 
Uncalled bet (2565) returned to grangala909
grangala909 collected 4395 from pot
grangala909: doesn't show hand 
*** SUMMARY ***
Total pot 4395 | Rake 0 
Board [Jc 4s 8d 7s As]
Seat 1: struikmat folded before Flop (didn't bet)
Seat 2: grangala909 collected (4395)
Seat 3: casiodk333 folded on the River
Seat 4: Roger321 folded on the Turn
Seat 5: JESSE-JMS folded before Flop (didn't bet)
Seat 6: S2698 folded before Flop (didn't bet)
Seat 7: manthos401 (button) folded before Flop (didn't bet)
Seat 8: anjodsk (small blind) folded before Flop
Seat 9: NINJA 007 PW (big blind) folded on the Flop



PokerStars Hand #132872662201: Tournament #1164585221, $20+$2 USD Hold'em No Limit - Level IX (75/150) - 2015/03/29 22:11:29 CET [2015/03/29 16:11:29 ET]
Table '1164585221 5160' 9-max Seat #8 is the button
Seat 1: struikmat (8545 in chips) 
Seat 2: grangala909 (6960 in chips) 
Seat 3: casiodk333 (6606 in chips) 
Seat 4: Roger321 (8456 in chips) 
Seat 5: JESSE-JMS (16256 in chips) 
Seat 6: S2698 (14091 in chips) 
Seat 7: manthos401 (28055 in chips) 
Seat 8: anjodsk (8628 in chips) 
Seat 9: NINJA 007 PW (8285 in chips) 
struikmat: posts the ante 20
grangala909: posts the ante 20
casiodk333: posts the ante 20
Roger321: posts the ante 20
JESSE-JMS: posts the ante 20
S2698: posts the ante 20
manthos401: posts the ante 20
anjodsk: posts the ante 20
NINJA 007 PW: posts the ante 20
NINJA 007 PW: posts small blind 75
struikmat: posts big blind 150
*** HOLE CARDS ***
Dealt to casiodk333 [3c 8d]
grangala909: folds 
casiodk333: folds 
Roger321: folds 
JESSE-JMS: folds 
S2698: folds 
manthos401: calls 150
anjodsk: folds 
NINJA 007 PW: calls 75
struikmat: checks 
*** FLOP *** [Ts 6c Kh]
NINJA 007 PW: checks 
struikmat: checks 
manthos401: bets 300
NINJA 007 PW: calls 300
struikmat: folds 
*** TURN *** [Ts 6c Kh] [Qh]
NINJA 007 PW: checks 
manthos401: checks 
*** RIVER *** [Ts 6c Kh Qh] [4d]
NINJA 007 PW: bets 738
manthos401: folds 
Uncalled bet (738) returned to NINJA 007 PW
NINJA 007 PW collected 1230 from pot
NINJA 007 PW: doesn't show hand 
*** SUMMARY ***
Total pot 1230 | Rake 0 
Board [Ts 6c Kh Qh 4d]
Seat 1: struikmat (big blind) folded on the Flop
Seat 2: grangala909 folded before Flop (didn't bet)
Seat 3: casiodk333 folded before Flop (didn't bet)
Seat 4: Roger321 folded before Flop (didn't bet)
Seat 5: JESSE-JMS folded before Flop (didn't bet)
Seat 6: S2698 folded before Flop (didn't bet)
Seat 7: manthos401 folded on the River
Seat 8: anjodsk (button) folded before Flop (didn't bet)
Seat 9: NINJA 007 PW (small blind) collected (1230)



PokerStars Hand #132872782035: Tournament #1164585221, $20+$2 USD Hold'em No Limit - Level IX (75/150) - 2015/03/29 22:13:06 CET [2015/03/29 16:13:06 ET]
Table '1164585221 5160' 9-max Seat #9 is the button
Seat 1: struikmat (8375 in chips) 
Seat 2: grangala909 (6940 in chips) 
Seat 3: casiodk333 (6586 in chips) 
Seat 4: Roger321 (8436 in chips) 
Seat 5: JESSE-JMS (16236 in chips) 
Seat 6: S2698 (14071 in chips) 
Seat 7: manthos401 (27585 in chips) 
Seat 8: anjodsk (8608 in chips) 
Seat 9: NINJA 007 PW (9045 in chips) 
struikmat: posts the ante 20
grangala909: posts the ante 20
casiodk333: posts the ante 20
Roger321: posts the ante 20
JESSE-JMS: posts the ante 20
S2698: posts the ante 20
manthos401: posts the ante 20
anjodsk: posts the ante 20
NINJA 007 PW: posts the ante 20
struikmat: posts small blind 75
grangala909: posts big blind 150
*** HOLE CARDS ***
Dealt to casiodk333 [2c Ac]
casiodk333: calls 150
Roger321: folds 
JESSE-JMS: folds 
S2698: folds 
manthos401: calls 150
anjodsk: folds 
NINJA 007 PW: calls 150
struikmat: calls 75
grangala909: checks 
*** FLOP *** [Qd 3h 7s]
struikmat: checks 
grangala909: checks 
casiodk333: checks 
manthos401: checks 
NINJA 007 PW: checks 
*** TURN *** [Qd 3h 7s] [8d]
struikmat: checks 
grangala909: checks 
casiodk333: bets 825
manthos401: calls 825
NINJA 007 PW: folds 
struikmat: folds 
grangala909: folds 
*** RIVER *** [Qd 3h 7s 8d] [9h]
casiodk333: checks 
manthos401: bets 1350
casiodk333: folds 
Uncalled bet (1350) returned to manthos401
manthos401 collected 2580 from pot
manthos401: doesn't show hand 
*** SUMMARY ***
Total pot 2580 | Rake 0 
Board [Qd 3h 7s 8d 9h]
Seat 1: struikmat (small blind) folded on the Turn
Seat 2: grangala909 (big blind) folded on the Turn
Seat 3: casiodk333 folded on the River
Seat 4: Roger321 folded before Flop (didn't bet)
Seat 5: JESSE-JMS folded before Flop (didn't bet)
Seat 6: S2698 folded before Flop (didn't bet)
Seat 7: manthos401 collected (2580)
Seat 8: anjodsk folded before Flop (didn't bet)
Seat 9: NINJA 007 PW (button) folded on the Turn



PokerStars Hand #132872918106: Tournament #1164585221, $20+$2 USD Hold'em No Limit - Level IX (75/150) - 2015/03/29 22:14:58 CET [2015/03/29 16:14:58 ET]
Table '1164585221 5160' 9-max Seat #1 is the button
Seat 1: struikmat (8205 in chips) 
Seat 2: grangala909 (6770 in chips) 
Seat 3: casiodk333 (5591 in chips) 
Seat 4: Roger321 (8416 in chips) 
Seat 5: JESSE-JMS (16216 in chips) 
Seat 6: S2698 (14051 in chips) 
Seat 7: manthos401 (29170 in chips) 
Seat 8: anjodsk (8588 in chips) 
Seat 9: NINJA 007 PW (8875 in chips) 
struikmat: posts the ante 20
grangala909: posts the ante 20
casiodk333: posts the ante 20
Roger321: posts the ante 20
JESSE-JMS: posts the ante 20
S2698: posts the ante 20
manthos401: posts the ante 20
anjodsk: posts the ante 20
NINJA 007 PW: posts the ante 20
grangala909: posts small blind 75
casiodk333: posts big blind 150
*** HOLE CARDS ***
Dealt to casiodk333 [9h 5h]
Roger321: folds 
JESSE-JMS: folds 
S2698: folds 
manthos401: raises 300 to 450
anjodsk: folds 
NINJA 007 PW: folds 
struikmat: folds 
grangala909: calls 375
casiodk333: calls 300
*** FLOP *** [Ks Jc 6c]
grangala909: checks 
casiodk333: checks 
manthos401: bets 750
grangala909: raises 1050 to 1800
casiodk333: folds 
manthos401: folds 
Uncalled bet (1050) returned to grangala909
grangala909 collected 3030 from pot
*** SUMMARY ***
Total pot 3030 | Rake 0 
Board [Ks Jc 6c]
Seat 1: struikmat (button) folded before Flop (didn't bet)
Seat 2: grangala909 (small blind) collected (3030)
Seat 3: casiodk333 (big blind) folded on the Flop
Seat 4: Roger321 folded before Flop (didn't bet)
Seat 5: JESSE-JMS folded before Flop (didn't bet)
Seat 6: S2698 folded before Flop (didn't bet)
Seat 7: manthos401 folded on the Flop
Seat 8: anjodsk folded before Flop (didn't bet)
Seat 9: NINJA 007 PW folded before Flop (didn't bet)



PokerStars Hand #132873006841: Tournament #1164585221, $20+$2 USD Hold'em No Limit - Level IX (75/150) - 2015/03/29 22:16:10 CET [2015/03/29 16:16:10 ET]
Table '1164585221 5160' 9-max Seat #2 is the button
Seat 1: struikmat (8185 in chips) 
Seat 2: grangala909 (8580 in chips) 
Seat 3: casiodk333 (5121 in chips) 
Seat 4: Roger321 (8396 in chips) 
Seat 5: JESSE-JMS (16196 in chips) 
Seat 6: S2698 (14031 in chips) 
Seat 7: manthos401 (27950 in chips) 
Seat 8: anjodsk (8568 in chips) 
Seat 9: NINJA 007 PW (8855 in chips) 
struikmat: posts the ante 20
grangala909: posts the ante 20
casiodk333: posts the ante 20
Roger321: posts the ante 20
JESSE-JMS: posts the ante 20
S2698: posts the ante 20
manthos401: posts the ante 20
anjodsk: posts the ante 20
NINJA 007 PW: posts the ante 20
casiodk333: posts small blind 75
Roger321: posts big blind 150
*** HOLE CARDS ***
Dealt to casiodk333 [9s 8d]
JESSE-JMS: folds 
S2698: calls 150
manthos401: folds 
anjodsk: raises 300 to 450
NINJA 007 PW: folds 
struikmat: folds 
grangala909: calls 450
casiodk333: folds 
Roger321: calls 300
S2698: calls 300
*** FLOP *** [7s 8h 2c]
Roger321: checks 
S2698: checks 
anjodsk: checks 
grangala909: bets 900
Roger321: folds 
S2698: folds 
anjodsk: folds 
Uncalled bet (900) returned to grangala909
grangala909 collected 2055 from pot
grangala909: doesn't show hand 
*** SUMMARY ***
Total pot 2055 | Rake 0 
Board [7s 8h 2c]
Seat 1: struikmat folded before Flop (didn't bet)
Seat 2: grangala909 (button) collected (2055)
Seat 3: casiodk333 (small blind) folded before Flop
Seat 4: Roger321 (big blind) folded on the Flop
Seat 5: JESSE-JMS folded before Flop (didn't bet)
Seat 6: S2698 folded on the Flop
Seat 7: manthos401 folded before Flop (didn't bet)
Seat 8: anjodsk folded on the Flop
Seat 9: NINJA 007 PW folded before Flop (didn't bet)



PokerStars Hand #132873118539: Tournament #1164585221, $20+$2 USD Hold'em No Limit - Level IX (75/150) - 2015/03/29 22:17:42 CET [2015/03/29 16:17:42 ET]
Table '1164585221 5160' 9-max Seat #3 is the button
Seat 1: struikmat (8165 in chips) 
Seat 2: grangala909 (10165 in chips) 
Seat 3: casiodk333 (5026 in chips) 
Seat 4: Roger321 (7926 in chips) 
Seat 5: JESSE-JMS (16176 in chips) 
Seat 6: S2698 (13561 in chips) 
Seat 7: manthos401 (27930 in chips) 
Seat 8: anjodsk (8098 in chips) 
Seat 9: NINJA 007 PW (8835 in chips) 
struikmat: posts the ante 20
grangala909: posts the ante 20
casiodk333: posts the ante 20
Roger321: posts the ante 20
JESSE-JMS: posts the ante 20
S2698: posts the ante 20
manthos401: posts the ante 20
anjodsk: posts the ante 20
NINJA 007 PW: posts the ante 20
Roger321: posts small blind 75
JESSE-JMS: posts big blind 150
*** HOLE CARDS ***
Dealt to casiodk333 [4d 8d]
S2698: folds 
manthos401: folds 
anjodsk: folds 
NINJA 007 PW: folds 
struikmat: folds 
grangala909: raises 150 to 300
casiodk333: folds 
Roger321: calls 225
JESSE-JMS: calls 150
*** FLOP *** [6h 7c 9c]
Roger321: checks 
JESSE-JMS: checks 
grangala909: checks 
*** TURN *** [6h 7c 9c] [Tc]
Roger321: checks 
JESSE-JMS: checks 
grangala909: checks 
*** RIVER *** [6h 7c 9c Tc] [3d]
Roger321: bets 450
JESSE-JMS: calls 450
grangala909: folds [Jh Ad]
*** SHOW DOWN ***
Roger321: shows [Js Ac] (high card Ace)
JESSE-JMS: shows [Ts 7h] (two pair, Tens and Sevens)
JESSE-JMS collected 1980 from pot
*** SUMMARY ***
Total pot 1980 | Rake 0 
Board [6h 7c 9c Tc 3d]
Seat 1: struikmat folded before Flop (didn't bet)
Seat 2: grangala909 folded on the River
Seat 3: casiodk333 (button) folded before Flop (didn't bet)
Seat 4: Roger321 (small blind) showed [Js Ac] and lost with high card Ace
Seat 5: JESSE-JMS (big blind) showed [Ts 7h] and won (1980) with two pair, Tens and Sevens
Seat 6: S2698 folded before Flop (didn't bet)
Seat 7: manthos401 folded before Flop (didn't bet)
Seat 8: anjodsk folded before Flop (didn't bet)
Seat 9: NINJA 007 PW folded before Flop (didn't bet)



PokerStars Hand #132873222695: Tournament #1164585221, $20+$2 USD Hold'em No Limit - Level IX (75/150) - 2015/03/29 22:19:03 CET [2015/03/29 16:19:03 ET]
Table '1164585221 5160' 9-max Seat #4 is the button
Seat 1: struikmat (8145 in chips) 
Seat 2: grangala909 (9845 in chips) 
Seat 3: casiodk333 (5006 in chips) 
Seat 4: Roger321 (7156 in chips) 
Seat 5: JESSE-JMS (17386 in chips) 
Seat 6: S2698 (13541 in chips) 
Seat 7: manthos401 (27910 in chips) 
Seat 8: anjodsk (8078 in chips) 
Seat 9: NINJA 007 PW (8815 in chips) 
struikmat: posts the ante 20
grangala909: posts the ante 20
casiodk333: posts the ante 20
Roger321: posts the ante 20
JESSE-JMS: posts the ante 20
S2698: posts the ante 20
manthos401: posts the ante 20
anjodsk: posts the ante 20
NINJA 007 PW: posts the ante 20
JESSE-JMS: posts small blind 75
S2698: posts big blind 150
*** HOLE CARDS ***
Dealt to casiodk333 [Tc 9d]
manthos401: calls 150
anjodsk: folds 
NINJA 007 PW: folds 
struikmat: calls 150
grangala909: folds 
casiodk333: calls 150
Roger321: calls 150
JESSE-JMS: calls 75
S2698: checks 
*** FLOP *** [8s 6d 5s]
JESSE-JMS: checks 
S2698: checks 
manthos401: bets 450
struikmat: folds 
casiodk333: folds 
Roger321: raises 1350 to 1800
JESSE-JMS: folds 
S2698: folds 
manthos401: calls 1350
*** TURN *** [8s 6d 5s] [Js]
manthos401: checks 
Roger321: bets 1500
manthos401: folds 
Uncalled bet (1500) returned to Roger321
Roger321 collected 4680 from pot
Roger321: doesn't show hand 
*** SUMMARY ***
Total pot 4680 | Rake 0 
Board [8s 6d 5s Js]
Seat 1: struikmat folded on the Flop
Seat 2: grangala909 folded before Flop (didn't bet)
Seat 3: casiodk333 folded on the Flop
Seat 4: Roger321 (button) collected (4680)
Seat 5: JESSE-JMS (small blind) folded on the Flop
Seat 6: S2698 (big blind) folded on the Flop
Seat 7: manthos401 folded on the Turn
Seat 8: anjodsk folded before Flop (didn't bet)
Seat 9: NINJA 007 PW folded before Flop (didn't bet)



PokerStars Hand #132873303703: Tournament #1164585221, $20+$2 USD Hold'em No Limit - Level IX (75/150) - 2015/03/29 22:20:08 CET [2015/03/29 16:20:08 ET]
Table '1164585221 5160' 9-max Seat #5 is the button
Seat 1: struikmat (7975 in chips) 
Seat 2: grangala909 (9825 in chips) 
Seat 3: casiodk333 (4836 in chips) 
Seat 4: Roger321 (9866 in chips) 
Seat 5: JESSE-JMS (17216 in chips) 
Seat 6: S2698 (13371 in chips) 
Seat 7: manthos401 (25940 in chips) 
Seat 8: anjodsk (8058 in chips) 
Seat 9: NINJA 007 PW (8795 in chips) 
struikmat: posts the ante 20
grangala909: posts the ante 20
casiodk333: posts the ante 20
Roger321: posts the ante 20
JESSE-JMS: posts the ante 20
S2698: posts the ante 20
manthos401: posts the ante 20
anjodsk: posts the ante 20
NINJA 007 PW: posts the ante 20
S2698: posts small blind 75
manthos401: posts big blind 150
*** HOLE CARDS ***
Dealt to casiodk333 [3d 5h]
anjodsk: folds 
NINJA 007 PW: folds 
struikmat: raises 300 to 450
grangala909: folds 
casiodk333: folds 
Roger321: folds 
JESSE-JMS: calls 450
S2698: folds 
manthos401: calls 300
*** FLOP *** [2h Td 6h]
manthos401: checks 
struikmat: bets 999
JESSE-JMS: calls 999
manthos401: folds 
*** TURN *** [2h Td 6h] [7h]
struikmat: bets 2450
JESSE-JMS: calls 2450
*** RIVER *** [2h Td 6h 7h] [6s]
struikmat: bets 4056 and is all-in
JESSE-JMS: calls 4056
*** SHOW DOWN ***
struikmat: shows [9s 9c] (two pair, Nines and Sixes)
JESSE-JMS: shows [Jh Th] (a flush, Jack high)
JESSE-JMS collected 16615 from pot
struikmat finished the tournament in 45019th place
*** SUMMARY ***
Total pot 16615 | Rake 0 
Board [2h Td 6h 7h 6s]
Seat 1: struikmat showed [9s 9c] and lost with two pair, Nines and Sixes
Seat 2: grangala909 folded before Flop (didn't bet)
Seat 3: casiodk333 folded before Flop (didn't bet)
Seat 4: Roger321 folded before Flop (didn't bet)
Seat 5: JESSE-JMS (button) showed [Jh Th] and won (16615) with a flush, Jack high
Seat 6: S2698 (small blind) folded before Flop
Seat 7: manthos401 (big blind) folded on the Flop
Seat 8: anjodsk folded before Flop (didn't bet)
Seat 9: NINJA 007 PW folded before Flop (didn't bet)



PokerStars Hand #132873398635: Tournament #1164585221, $20+$2 USD Hold'em No Limit - Level X (100/200) - 2015/03/29 22:21:25 CET [2015/03/29 16:21:25 ET]
Table '1164585221 164' 9-max Seat #2 is the button
Seat 1: srob8075 (8466 in chips) 
Seat 2: NicilaWCOOP (12120 in chips) 
Seat 3: mr.DronSemen (16196 in chips) 
Seat 4: walliwasya (16545 in chips) 
Seat 5: kimhenry68 (17605 in chips) 
Seat 6: TACFOUR (12278 in chips) 
Seat 7: Spaix (19989 in chips) 
Seat 8: casiodk333 (4816 in chips) 
Seat 9: Schwaetzer84 (9980 in chips) 
srob8075: posts the ante 25
NicilaWCOOP: posts the ante 25
mr.DronSemen: posts the ante 25
walliwasya: posts the ante 25
kimhenry68: posts the ante 25
TACFOUR: posts the ante 25
Spaix: posts the ante 25
casiodk333: posts the ante 25
Schwaetzer84: posts the ante 25
mr.DronSemen: posts small blind 100
walliwasya: posts big blind 200
*** HOLE CARDS ***
Dealt to casiodk333 [Ks 9c]
kimhenry68: raises 200 to 400
TACFOUR: calls 400
Spaix: folds 
casiodk333: calls 400
Schwaetzer84: folds 
srob8075: raises 1300 to 1700
NicilaWCOOP: folds 
mr.DronSemen: folds 
walliwasya: folds 
kimhenry68: folds 
TACFOUR: calls 1300
casiodk333: calls 1300
*** FLOP *** [6s 8h 7d]
TACFOUR: checks 
casiodk333: bets 3091 and is all-in
srob8075: raises 3650 to 6741 and is all-in
TACFOUR: folds 
Uncalled bet (3650) returned to srob8075
*** TURN *** [6s 8h 7d] [5c]
*** RIVER *** [6s 8h 7d 5c] [2d]
*** SHOW DOWN ***
casiodk333: shows [Ks 9c] (a straight, Five to Nine)
srob8075: shows [Qh Qd] (a pair of Queens)
casiodk333 collected 12207 from pot
*** SUMMARY ***
Total pot 12207 | Rake 0 
Board [6s 8h 7d 5c 2d]
Seat 1: srob8075 showed [Qh Qd] and lost with a pair of Queens
Seat 2: NicilaWCOOP (button) folded before Flop (didn't bet)
Seat 3: mr.DronSemen (small blind) folded before Flop
Seat 4: walliwasya (big blind) folded before Flop
Seat 5: kimhenry68 folded before Flop
Seat 6: TACFOUR folded on the Flop
Seat 7: Spaix folded before Flop (didn't bet)
Seat 8: casiodk333 showed [Ks 9c] and won (12207) with a straight, Five to Nine
Seat 9: Schwaetzer84 folded before Flop (didn't bet)



PokerStars Hand #132873475336: Tournament #1164585221, $20+$2 USD Hold'em No Limit - Level X (100/200) - 2015/03/29 22:22:27 CET [2015/03/29 16:22:27 ET]
Table '1164585221 164' 9-max Seat #3 is the button
Seat 1: srob8075 (3650 in chips) 
Seat 2: NicilaWCOOP (12095 in chips) 
Seat 3: mr.DronSemen (16071 in chips) 
Seat 4: walliwasya (16320 in chips) 
Seat 5: kimhenry68 (17180 in chips) 
Seat 6: TACFOUR (10553 in chips) 
Seat 7: Spaix (19964 in chips) 
Seat 8: casiodk333 (12207 in chips) 
Seat 9: Schwaetzer84 (9955 in chips) 
srob8075: posts the ante 25
NicilaWCOOP: posts the ante 25
mr.DronSemen: posts the ante 25
walliwasya: posts the ante 25
kimhenry68: posts the ante 25
TACFOUR: posts the ante 25
Spaix: posts the ante 25
casiodk333: posts the ante 25
Schwaetzer84: posts the ante 25
walliwasya: posts small blind 100
kimhenry68: posts big blind 200
*** HOLE CARDS ***
Dealt to casiodk333 [3c Js]
TACFOUR: folds 
Spaix: folds 
casiodk333: folds 
Schwaetzer84: raises 400 to 600
srob8075: calls 600
NicilaWCOOP: folds 
mr.DronSemen: folds 
walliwasya: folds 
kimhenry68: folds 
*** FLOP *** [Ks Jd Td]
Schwaetzer84: checks 
srob8075: checks 
*** TURN *** [Ks Jd Td] [8d]
Schwaetzer84: checks 
srob8075: bets 200
Schwaetzer84: folds 
Uncalled bet (200) returned to srob8075
srob8075 collected 1725 from pot
srob8075: doesn't show hand 
*** SUMMARY ***
Total pot 1725 | Rake 0 
Board [Ks Jd Td 8d]
Seat 1: srob8075 collected (1725)
Seat 2: NicilaWCOOP folded before Flop (didn't bet)
Seat 3: mr.DronSemen (button) folded before Flop (didn't bet)
Seat 4: walliwasya (small blind) folded before Flop
Seat 5: kimhenry68 (big blind) folded before Flop
Seat 6: TACFOUR folded before Flop (didn't bet)
Seat 7: Spaix folded before Flop (didn't bet)
Seat 8: casiodk333 folded before Flop (didn't bet)
Seat 9: Schwaetzer84 folded on the Turn



PokerStars Hand #132873537717: Tournament #1164585221, $20+$2 USD Hold'em No Limit - Level X (100/200) - 2015/03/29 22:23:19 CET [2015/03/29 16:23:19 ET]
Table '1164585221 164' 9-max Seat #4 is the button
Seat 1: srob8075 (4750 in chips) 
Seat 2: NicilaWCOOP (12070 in chips) 
Seat 3: mr.DronSemen (16046 in chips) 
Seat 4: walliwasya (16195 in chips) 
Seat 5: kimhenry68 (16955 in chips) 
Seat 6: TACFOUR (10528 in chips) 
Seat 7: Spaix (19939 in chips) 
Seat 8: casiodk333 (12182 in chips) 
Seat 9: Schwaetzer84 (9330 in chips) 
srob8075: posts the ante 25
NicilaWCOOP: posts the ante 25
mr.DronSemen: posts the ante 25
walliwasya: posts the ante 25
kimhenry68: posts the ante 25
TACFOUR: posts the ante 25
Spaix: posts the ante 25
casiodk333: posts the ante 25
Schwaetzer84: posts the ante 25
kimhenry68: posts small blind 100
TACFOUR: posts big blind 200
*** HOLE CARDS ***
Dealt to casiodk333 [Jd 8d]
Spaix: raises 200 to 400
casiodk333: folds 
Schwaetzer84: folds 
srob8075: folds 
NicilaWCOOP: folds 
mr.DronSemen: calls 400
walliwasya: folds 
kimhenry68: folds 
TACFOUR: calls 200
*** FLOP *** [6c 4s 5d]
TACFOUR: checks 
Spaix: bets 762
mr.DronSemen: calls 762
TACFOUR: calls 762
*** TURN *** [6c 4s 5d] [8c]
TACFOUR: checks 
Spaix: checks 
mr.DronSemen: bets 1600
TACFOUR: raises 2000 to 3600
Spaix: folds 
mr.DronSemen: calls 2000
*** RIVER *** [6c 4s 5d 8c] [Qd]
TACFOUR: bets 5741 and is all-in
mr.DronSemen: calls 5741
*** SHOW DOWN ***
TACFOUR: shows [7d 6d] (a straight, Four to Eight)
mr.DronSemen: shows [Ks 7s] (a straight, Four to Eight)
TACFOUR collected 11247 from pot
mr.DronSemen collected 11246 from pot
*** SUMMARY ***
Total pot 22493 | Rake 0 
Board [6c 4s 5d 8c Qd]
Seat 1: srob8075 folded before Flop (didn't bet)
Seat 2: NicilaWCOOP folded before Flop (didn't bet)
Seat 3: mr.DronSemen showed [Ks 7s] and won (11246) with a straight, Four to Eight
Seat 4: walliwasya (button) folded before Flop (didn't bet)
Seat 5: kimhenry68 (small blind) folded before Flop
Seat 6: TACFOUR (big blind) showed [7d 6d] and won (11247) with a straight, Four to Eight
Seat 7: Spaix folded on the Turn
Seat 8: casiodk333 folded before Flop (didn't bet)
Seat 9: Schwaetzer84 folded before Flop (didn't bet)



PokerStars Hand #132873627111: Tournament #1164585221, $20+$2 USD Hold'em No Limit - Level X (100/200) - 2015/03/29 22:24:32 CET [2015/03/29 16:24:32 ET]
Table '1164585221 164' 9-max Seat #5 is the button
Seat 1: srob8075 (4725 in chips) 
Seat 2: NicilaWCOOP (12045 in chips) 
Seat 3: mr.DronSemen (16764 in chips) 
Seat 4: walliwasya (16170 in chips) 
Seat 5: kimhenry68 (16830 in chips) 
Seat 6: TACFOUR (11247 in chips) 
Seat 7: Spaix (18752 in chips) 
Seat 8: casiodk333 (12157 in chips) 
Seat 9: Schwaetzer84 (9305 in chips) 
srob8075: posts the ante 25
NicilaWCOOP: posts the ante 25
mr.DronSemen: posts the ante 25
walliwasya: posts the ante 25
kimhenry68: posts the ante 25
TACFOUR: posts the ante 25
Spaix: posts the ante 25
casiodk333: posts the ante 25
Schwaetzer84: posts the ante 25
TACFOUR: posts small blind 100
Spaix: posts big blind 200
*** HOLE CARDS ***
Dealt to casiodk333 [Kh Kc]
casiodk333: calls 200
Schwaetzer84: folds 
srob8075: folds 
NicilaWCOOP: folds 
mr.DronSemen: folds 
walliwasya: folds 
kimhenry68: folds 
TACFOUR: calls 100
Spaix: checks 
*** FLOP *** [8h 9d Ac]
TACFOUR: checks 
Spaix: checks 
casiodk333: bets 200
TACFOUR: folds 
Spaix: folds 
Uncalled bet (200) returned to casiodk333
casiodk333 collected 825 from pot
*** SUMMARY ***
Total pot 825 | Rake 0 
Board [8h 9d Ac]
Seat 1: srob8075 folded before Flop (didn't bet)
Seat 2: NicilaWCOOP folded before Flop (didn't bet)
Seat 3: mr.DronSemen folded before Flop (didn't bet)
Seat 4: walliwasya folded before Flop (didn't bet)
Seat 5: kimhenry68 (button) folded before Flop (didn't bet)
Seat 6: TACFOUR (small blind) folded on the Flop
Seat 7: Spaix (big blind) folded on the Flop
Seat 8: casiodk333 collected (825)
Seat 9: Schwaetzer84 folded before Flop (didn't bet)



PokerStars Hand #132873670278: Tournament #1164585221, $20+$2 USD Hold'em No Limit - Level X (100/200) - 2015/03/29 22:25:06 CET [2015/03/29 16:25:06 ET]
Table '1164585221 164' 9-max Seat #6 is the button
Seat 1: srob8075 (4700 in chips) 
Seat 2: NicilaWCOOP (12020 in chips) 
Seat 3: mr.DronSemen (16739 in chips) 
Seat 4: walliwasya (16145 in chips) 
Seat 5: kimhenry68 (16805 in chips) 
Seat 6: TACFOUR (11022 in chips) 
Seat 7: Spaix (18527 in chips) 
Seat 8: casiodk333 (12757 in chips) 
Seat 9: Schwaetzer84 (9280 in chips) 
srob8075: posts the ante 25
NicilaWCOOP: posts the ante 25
mr.DronSemen: posts the ante 25
walliwasya: posts the ante 25
kimhenry68: posts the ante 25
TACFOUR: posts the ante 25
Spaix: posts the ante 25
casiodk333: posts the ante 25
Schwaetzer84: posts the ante 25
Spaix: posts small blind 100
casiodk333: posts big blind 200
*** HOLE CARDS ***
Dealt to casiodk333 [Qc 3s]
Schwaetzer84: raises 400 to 600
srob8075: folds 
NicilaWCOOP: folds 
mr.DronSemen: folds 
walliwasya: folds 
kimhenry68: folds 
TACFOUR: folds 
Spaix: folds 
casiodk333: folds 
Uncalled bet (400) returned to Schwaetzer84
Schwaetzer84 collected 725 from pot
Schwaetzer84: doesn't show hand 
*** SUMMARY ***
Total pot 725 | Rake 0 
Seat 1: srob8075 folded before Flop (didn't bet)
Seat 2: NicilaWCOOP folded before Flop (didn't bet)
Seat 3: mr.DronSemen folded before Flop (didn't bet)
Seat 4: walliwasya folded before Flop (didn't bet)
Seat 5: kimhenry68 folded before Flop (didn't bet)
Seat 6: TACFOUR (button) folded before Flop (didn't bet)
Seat 7: Spaix (small blind) folded before Flop
Seat 8: casiodk333 (big blind) folded before Flop
Seat 9: Schwaetzer84 collected (725)



PokerStars Hand #132873711602: Tournament #1164585221, $20+$2 USD Hold'em No Limit - Level X (100/200) - 2015/03/29 22:25:40 CET [2015/03/29 16:25:40 ET]
Table '1164585221 164' 9-max Seat #7 is the button
Seat 1: srob8075 (4675 in chips) 
Seat 2: NicilaWCOOP (11995 in chips) 
Seat 3: mr.DronSemen (16714 in chips) 
Seat 4: walliwasya (16120 in chips) 
Seat 5: kimhenry68 (16780 in chips) 
Seat 6: TACFOUR (10997 in chips) 
Seat 7: Spaix (18402 in chips) 
Seat 8: casiodk333 (12532 in chips) 
Seat 9: Schwaetzer84 (9780 in chips) 
srob8075: posts the ante 25
NicilaWCOOP: posts the ante 25
mr.DronSemen: posts the ante 25
walliwasya: posts the ante 25
kimhenry68: posts the ante 25
TACFOUR: posts the ante 25
Spaix: posts the ante 25
casiodk333: posts the ante 25
Schwaetzer84: posts the ante 25
casiodk333: posts small blind 100
Schwaetzer84: posts big blind 200
*** HOLE CARDS ***
Dealt to casiodk333 [9c 8h]
srob8075: folds 
NicilaWCOOP: folds 
mr.DronSemen: folds 
walliwasya: folds 
kimhenry68: raises 200 to 400
TACFOUR: folds 
Spaix: raises 600 to 1000
casiodk333: folds 
Schwaetzer84: folds 
kimhenry68: folds 
Uncalled bet (600) returned to Spaix
Spaix collected 1325 from pot
Spaix: doesn't show hand 
*** SUMMARY ***
Total pot 1325 | Rake 0 
Seat 1: srob8075 folded before Flop (didn't bet)
Seat 2: NicilaWCOOP folded before Flop (didn't bet)
Seat 3: mr.DronSemen folded before Flop (didn't bet)
Seat 4: walliwasya folded before Flop (didn't bet)
Seat 5: kimhenry68 folded before Flop
Seat 6: TACFOUR folded before Flop (didn't bet)
Seat 7: Spaix (button) collected (1325)
Seat 8: casiodk333 (small blind) folded before Flop
Seat 9: Schwaetzer84 (big blind) folded before Flop



PokerStars Hand #132873765752: Tournament #1164585221, $20+$2 USD Hold'em No Limit - Level X (100/200) - 2015/03/29 22:26:24 CET [2015/03/29 16:26:24 ET]
Table '1164585221 164' 9-max Seat #8 is the button
Seat 1: srob8075 (4650 in chips) 
Seat 2: NicilaWCOOP (11970 in chips) 
Seat 3: mr.DronSemen (16689 in chips) 
Seat 4: walliwasya (16095 in chips) 
Seat 5: kimhenry68 (16355 in chips) 
Seat 6: TACFOUR (10972 in chips) 
Seat 7: Spaix (19302 in chips) 
Seat 8: casiodk333 (12407 in chips) 
Seat 9: Schwaetzer84 (9555 in chips) 
srob8075: posts the ante 25
NicilaWCOOP: posts the ante 25
mr.DronSemen: posts the ante 25
walliwasya: posts the ante 25
kimhenry68: posts the ante 25
TACFOUR: posts the ante 25
Spaix: posts the ante 25
casiodk333: posts the ante 25
Schwaetzer84: posts the ante 25
Schwaetzer84: posts small blind 100
srob8075: posts big blind 200
*** HOLE CARDS ***
Dealt to casiodk333 [5s 9c]
NicilaWCOOP: folds 
mr.DronSemen: folds 
walliwasya: folds 
kimhenry68: folds 
TACFOUR: calls 200
Spaix: folds 
casiodk333: folds 
Schwaetzer84: calls 100
srob8075: checks 
*** FLOP *** [Kh Td 9d]
Schwaetzer84: checks 
srob8075: checks 
TACFOUR: bets 200
Schwaetzer84: calls 200
srob8075: folds 
*** TURN *** [Kh Td 9d] [6h]
Schwaetzer84: bets 816
TACFOUR: folds 
Uncalled bet (816) returned to Schwaetzer84
Schwaetzer84 collected 1225 from pot
Schwaetzer84: doesn't show hand 
*** SUMMARY ***
Total pot 1225 | Rake 0 
Board [Kh Td 9d 6h]
Seat 1: srob8075 (big blind) folded on the Flop
Seat 2: NicilaWCOOP folded before Flop (didn't bet)
Seat 3: mr.DronSemen folded before Flop (didn't bet)
Seat 4: walliwasya folded before Flop (didn't bet)
Seat 5: kimhenry68 folded before Flop (didn't bet)
Seat 6: TACFOUR folded on the Turn
Seat 7: Spaix folded before Flop (didn't bet)
Seat 8: casiodk333 (button) folded before Flop (didn't bet)
Seat 9: Schwaetzer84 (small blind) collected (1225)



PokerStars Hand #132873818132: Tournament #1164585221, $20+$2 USD Hold'em No Limit - Level X (100/200) - 2015/03/29 22:27:06 CET [2015/03/29 16:27:06 ET]
Table '1164585221 164' 9-max Seat #9 is the button
Seat 1: srob8075 (4425 in chips) 
Seat 2: NicilaWCOOP (11945 in chips) 
Seat 3: mr.DronSemen (16664 in chips) 
Seat 4: walliwasya (16070 in chips) 
Seat 5: kimhenry68 (16330 in chips) 
Seat 6: TACFOUR (10547 in chips) 
Seat 7: Spaix (19277 in chips) 
Seat 8: casiodk333 (12382 in chips) 
Seat 9: Schwaetzer84 (10355 in chips) 
srob8075: posts the ante 25
NicilaWCOOP: posts the ante 25
mr.DronSemen: posts the ante 25
walliwasya: posts the ante 25
kimhenry68: posts the ante 25
TACFOUR: posts the ante 25
Spaix: posts the ante 25
casiodk333: posts the ante 25
Schwaetzer84: posts the ante 25
srob8075: posts small blind 100
NicilaWCOOP: posts big blind 200
*** HOLE CARDS ***
Dealt to casiodk333 [7c 3s]
mr.DronSemen: folds 
walliwasya: folds 
kimhenry68: folds 
TACFOUR: folds 
Spaix: folds 
casiodk333: raises 300 to 500
Schwaetzer84: folds 
srob8075: folds 
NicilaWCOOP: folds 
Uncalled bet (300) returned to casiodk333
casiodk333 collected 725 from pot
*** SUMMARY ***
Total pot 725 | Rake 0 
Seat 1: srob8075 (small blind) folded before Flop
Seat 2: NicilaWCOOP (big blind) folded before Flop
Seat 3: mr.DronSemen folded before Flop (didn't bet)
Seat 4: walliwasya folded before Flop (didn't bet)
Seat 5: kimhenry68 folded before Flop (didn't bet)
Seat 6: TACFOUR folded before Flop (didn't bet)
Seat 7: Spaix folded before Flop (didn't bet)
Seat 8: casiodk333 collected (725)
Seat 9: Schwaetzer84 (button) folded before Flop (didn't bet)



PokerStars Hand #132873852578: Tournament #1164585221, $20+$2 USD Hold'em No Limit - Level X (100/200) - 2015/03/29 22:27:35 CET [2015/03/29 16:27:35 ET]
Table '1164585221 164' 9-max Seat #1 is the button
Seat 1: srob8075 (4300 in chips) 
Seat 2: NicilaWCOOP (11720 in chips) 
Seat 3: mr.DronSemen (16639 in chips) 
Seat 4: walliwasya (16045 in chips) 
Seat 5: kimhenry68 (16305 in chips) 
Seat 6: TACFOUR (10522 in chips) 
Seat 7: Spaix (19252 in chips) 
Seat 8: casiodk333 (12882 in chips) 
Seat 9: Schwaetzer84 (10330 in chips) 
srob8075: posts the ante 25
NicilaWCOOP: posts the ante 25
mr.DronSemen: posts the ante 25
walliwasya: posts the ante 25
kimhenry68: posts the ante 25
TACFOUR: posts the ante 25
Spaix: posts the ante 25
casiodk333: posts the ante 25
Schwaetzer84: posts the ante 25
NicilaWCOOP: posts small blind 100
mr.DronSemen: posts big blind 200
*** HOLE CARDS ***
Dealt to casiodk333 [6h Ah]
walliwasya: folds 
kimhenry68: folds 
TACFOUR: folds 
Spaix: folds 
casiodk333: calls 200
Schwaetzer84: calls 200
srob8075: calls 200
NicilaWCOOP: calls 100
mr.DronSemen: checks 
*** FLOP *** [Jc Jd Kd]
NicilaWCOOP: checks 
mr.DronSemen: checks 
casiodk333: bets 200
Schwaetzer84: raises 812 to 1012
srob8075: folds 
NicilaWCOOP: calls 1012
mr.DronSemen: folds 
casiodk333: folds 
*** TURN *** [Jc Jd Kd] [Kh]
NicilaWCOOP: checks 
Schwaetzer84: checks 
*** RIVER *** [Jc Jd Kd Kh] [4c]
NicilaWCOOP: checks 
Schwaetzer84: checks 
*** SHOW DOWN ***
NicilaWCOOP: shows [Qs Jh] (a full house, Jacks full of Kings)
Schwaetzer84: mucks hand 
NicilaWCOOP collected 3449 from pot
*** SUMMARY ***
Total pot 3449 | Rake 0 
Board [Jc Jd Kd Kh 4c]
Seat 1: srob8075 (button) folded on the Flop
Seat 2: NicilaWCOOP (small blind) showed [Qs Jh] and won (3449) with a full house, Jacks full of Kings
Seat 3: mr.DronSemen (big blind) folded on the Flop
Seat 4: walliwasya folded before Flop (didn't bet)
Seat 5: kimhenry68 folded before Flop (didn't bet)
Seat 6: TACFOUR folded before Flop (didn't bet)
Seat 7: Spaix folded before Flop (didn't bet)
Seat 8: casiodk333 folded on the Flop
Seat 9: Schwaetzer84 mucked [Qd 9d]



PokerStars Hand #132873930595: Tournament #1164585221, $20+$2 USD Hold'em No Limit - Level X (100/200) - 2015/03/29 22:28:39 CET [2015/03/29 16:28:39 ET]
Table '1164585221 164' 9-max Seat #2 is the button
Seat 1: srob8075 (4075 in chips) 
Seat 2: NicilaWCOOP (13932 in chips) 
Seat 3: mr.DronSemen (16414 in chips) 
Seat 4: walliwasya (16020 in chips) 
Seat 5: kimhenry68 (16280 in chips) 
Seat 6: TACFOUR (10497 in chips) 
Seat 7: Spaix (19227 in chips) 
Seat 8: casiodk333 (12457 in chips) 
Seat 9: Schwaetzer84 (9093 in chips) 
srob8075: posts the ante 25
NicilaWCOOP: posts the ante 25
mr.DronSemen: posts the ante 25
walliwasya: posts the ante 25
kimhenry68: posts the ante 25
TACFOUR: posts the ante 25
Spaix: posts the ante 25
casiodk333: posts the ante 25
Schwaetzer84: posts the ante 25
mr.DronSemen: posts small blind 100
walliwasya: posts big blind 200
*** HOLE CARDS ***
Dealt to casiodk333 [Qd 8c]
kimhenry68: folds 
TACFOUR: folds 
Spaix: folds 
casiodk333: folds 
Schwaetzer84: folds 
srob8075: raises 230 to 430
NicilaWCOOP: folds 
mr.DronSemen: folds 
walliwasya: folds 
Uncalled bet (230) returned to srob8075
srob8075 collected 725 from pot
srob8075: doesn't show hand 
*** SUMMARY ***
Total pot 725 | Rake 0 
Seat 1: srob8075 collected (725)
Seat 2: NicilaWCOOP (button) folded before Flop (didn't bet)
Seat 3: mr.DronSemen (small blind) folded before Flop
Seat 4: walliwasya (big blind) folded before Flop
Seat 5: kimhenry68 folded before Flop (didn't bet)
Seat 6: TACFOUR folded before Flop (didn't bet)
Seat 7: Spaix folded before Flop (didn't bet)
Seat 8: casiodk333 folded before Flop (didn't bet)
Seat 9: Schwaetzer84 folded before Flop (didn't bet)



PokerStars Hand #132873970538: Tournament #1164585221, $20+$2 USD Hold'em No Limit - Level X (100/200) - 2015/03/29 22:29:12 CET [2015/03/29 16:29:12 ET]
Table '1164585221 164' 9-max Seat #3 is the button
Seat 1: srob8075 (4575 in chips) 
Seat 2: NicilaWCOOP (13907 in chips) 
Seat 3: mr.DronSemen (16289 in chips) 
Seat 4: walliwasya (15795 in chips) 
Seat 5: kimhenry68 (16255 in chips) 
Seat 6: TACFOUR (10472 in chips) 
Seat 7: Spaix (19202 in chips) 
Seat 8: casiodk333 (12432 in chips) 
Seat 9: Schwaetzer84 (9068 in chips) 
srob8075: posts the ante 25
NicilaWCOOP: posts the ante 25
mr.DronSemen: posts the ante 25
walliwasya: posts the ante 25
kimhenry68: posts the ante 25
TACFOUR: posts the ante 25
Spaix: posts the ante 25
casiodk333: posts the ante 25
Schwaetzer84: posts the ante 25
walliwasya: posts small blind 100
kimhenry68: posts big blind 200
*** HOLE CARDS ***
Dealt to casiodk333 [8h Qh]
TACFOUR: folds 
Spaix: folds 
casiodk333: calls 200
Schwaetzer84: folds 
srob8075: raises 400 to 600
NicilaWCOOP: folds 
mr.DronSemen: folds 
walliwasya: folds 
kimhenry68: calls 400
casiodk333: calls 400
*** FLOP *** [Kc 2d 7s]
kimhenry68: bets 800
casiodk333: folds 
srob8075: folds 
Uncalled bet (800) returned to kimhenry68
kimhenry68 collected 2125 from pot
*** SUMMARY ***
Total pot 2125 | Rake 0 
Board [Kc 2d 7s]
Seat 1: srob8075 folded on the Flop
Seat 2: NicilaWCOOP folded before Flop (didn't bet)
Seat 3: mr.DronSemen (button) folded before Flop (didn't bet)
Seat 4: walliwasya (small blind) folded before Flop
Seat 5: kimhenry68 (big blind) collected (2125)
Seat 6: TACFOUR folded before Flop (didn't bet)
Seat 7: Spaix folded before Flop (didn't bet)
Seat 8: casiodk333 folded on the Flop
Seat 9: Schwaetzer84 folded before Flop (didn't bet)



PokerStars Hand #132874018807: Tournament #1164585221, $20+$2 USD Hold'em No Limit - Level X (100/200) - 2015/03/29 22:29:52 CET [2015/03/29 16:29:52 ET]
Table '1164585221 164' 9-max Seat #4 is the button
Seat 1: srob8075 (3950 in chips) 
Seat 2: NicilaWCOOP (13882 in chips) 
Seat 3: mr.DronSemen (16264 in chips) 
Seat 4: walliwasya (15670 in chips) 
Seat 5: kimhenry68 (17755 in chips) 
Seat 6: TACFOUR (10447 in chips) 
Seat 7: Spaix (19177 in chips) 
Seat 8: casiodk333 (11807 in chips) 
Seat 9: Schwaetzer84 (9043 in chips) 
srob8075: posts the ante 25
NicilaWCOOP: posts the ante 25
mr.DronSemen: posts the ante 25
walliwasya: posts the ante 25
kimhenry68: posts the ante 25
TACFOUR: posts the ante 25
Spaix: posts the ante 25
casiodk333: posts the ante 25
Schwaetzer84: posts the ante 25
kimhenry68: posts small blind 100
TACFOUR: posts big blind 200
*** HOLE CARDS ***
Dealt to casiodk333 [9s 5d]
Spaix: raises 200 to 400
casiodk333: folds 
Schwaetzer84: folds 
srob8075: folds 
NicilaWCOOP: raises 700 to 1100
mr.DronSemen: folds 
walliwasya: folds 
kimhenry68: folds 
TACFOUR: folds 
Spaix: calls 700
*** FLOP *** [Jd Tc Qc]
Spaix: checks 
NicilaWCOOP: bets 900
Spaix: raises 2262 to 3162
NicilaWCOOP: calls 2262
*** TURN *** [Jd Tc Qc] [4h]
Spaix: bets 4000
NicilaWCOOP: raises 5595 to 9595 and is all-in
Spaix: calls 5595
*** RIVER *** [Jd Tc Qc 4h] [5h]
*** SHOW DOWN ***
Spaix: shows [Ks Ah] (a straight, Ten to Ace)
NicilaWCOOP: shows [Ac Kd] (a straight, Ten to Ace)
Spaix collected 14120 from pot
NicilaWCOOP collected 14119 from pot
*** SUMMARY ***
Total pot 28239 | Rake 0 
Board [Jd Tc Qc 4h 5h]
Seat 1: srob8075 folded before Flop (didn't bet)
Seat 2: NicilaWCOOP showed [Ac Kd] and won (14119) with a straight, Ten to Ace
Seat 3: mr.DronSemen folded before Flop (didn't bet)
Seat 4: walliwasya (button) folded before Flop (didn't bet)
Seat 5: kimhenry68 (small blind) folded before Flop
Seat 6: TACFOUR (big blind) folded before Flop
Seat 7: Spaix showed [Ks Ah] and won (14120) with a straight, Ten to Ace
Seat 8: casiodk333 folded before Flop (didn't bet)
Seat 9: Schwaetzer84 folded before Flop (didn't bet)



PokerStars Hand #132874124986: Tournament #1164585221, $20+$2 USD Hold'em No Limit - Level XI (125/250) - 2015/03/29 22:31:24 CET [2015/03/29 16:31:24 ET]
Table '1164585221 164' 9-max Seat #5 is the button
Seat 1: srob8075 (3925 in chips) 
Seat 2: NicilaWCOOP (14119 in chips) 
Seat 3: mr.DronSemen (16239 in chips) 
Seat 4: walliwasya (15645 in chips) 
Seat 5: kimhenry68 (17630 in chips) 
Seat 6: TACFOUR (10222 in chips) 
Seat 7: Spaix (19415 in chips) 
Seat 8: casiodk333 (11782 in chips) 
Seat 9: Schwaetzer84 (9018 in chips) 
srob8075: posts the ante 30
NicilaWCOOP: posts the ante 30
mr.DronSemen: posts the ante 30
walliwasya: posts the ante 30
kimhenry68: posts the ante 30
TACFOUR: posts the ante 30
Spaix: posts the ante 30
casiodk333: posts the ante 30
Schwaetzer84: posts the ante 30
TACFOUR: posts small blind 125
Spaix: posts big blind 250
*** HOLE CARDS ***
Dealt to casiodk333 [7s 7d]
casiodk333: raises 375 to 625
Schwaetzer84: folds 
srob8075: folds 
NicilaWCOOP: folds 
mr.DronSemen: folds 
walliwasya: folds 
kimhenry68: folds 
TACFOUR: folds 
Spaix: folds 
Uncalled bet (375) returned to casiodk333
casiodk333 collected 895 from pot
*** SUMMARY ***
Total pot 895 | Rake 0 
Seat 1: srob8075 folded before Flop (didn't bet)
Seat 2: NicilaWCOOP folded before Flop (didn't bet)
Seat 3: mr.DronSemen folded before Flop (didn't bet)
Seat 4: walliwasya folded before Flop (didn't bet)
Seat 5: kimhenry68 (button) folded before Flop (didn't bet)
Seat 6: TACFOUR (small blind) folded before Flop
Seat 7: Spaix (big blind) folded before Flop
Seat 8: casiodk333 collected (895)
Seat 9: Schwaetzer84 folded before Flop (didn't bet)



PokerStars Hand #132874168727: Tournament #1164585221, $20+$2 USD Hold'em No Limit - Level XI (125/250) - 2015/03/29 22:32:00 CET [2015/03/29 16:32:00 ET]
Table '1164585221 164' 9-max Seat #6 is the button
Seat 1: srob8075 (3895 in chips) 
Seat 2: NicilaWCOOP (14089 in chips) 
Seat 3: mr.DronSemen (16209 in chips) 
Seat 4: walliwasya (15615 in chips) 
Seat 5: kimhenry68 (17600 in chips) 
Seat 6: TACFOUR (10067 in chips) 
Seat 7: Spaix (19135 in chips) 
Seat 8: casiodk333 (12397 in chips) 
Seat 9: Schwaetzer84 (8988 in chips) 
srob8075: posts the ante 30
NicilaWCOOP: posts the ante 30
mr.DronSemen: posts the ante 30
walliwasya: posts the ante 30
kimhenry68: posts the ante 30
TACFOUR: posts the ante 30
Spaix: posts the ante 30
casiodk333: posts the ante 30
Schwaetzer84: posts the ante 30
Spaix: posts small blind 125
casiodk333: posts big blind 250
*** HOLE CARDS ***
Dealt to casiodk333 [Jc 8s]
Schwaetzer84: folds 
srob8075: folds 
NicilaWCOOP: folds 
mr.DronSemen: raises 250 to 500
walliwasya: folds 
kimhenry68: folds 
TACFOUR: folds 
Spaix: calls 375
casiodk333: calls 250
*** FLOP *** [Td 8h 3c]
Spaix: checks 
casiodk333: checks 
mr.DronSemen: bets 750
Spaix: folds 
casiodk333: calls 750
*** TURN *** [Td 8h 3c] [7s]
casiodk333: checks 
mr.DronSemen: bets 2125
casiodk333: calls 2125
*** RIVER *** [Td 8h 3c 7s] [3d]
casiodk333: checks 
mr.DronSemen: checks 
*** SHOW DOWN ***
casiodk333: shows [Jc 8s] (two pair, Eights and Threes)
mr.DronSemen: shows [7c 8c] (two pair, Eights and Sevens)
mr.DronSemen collected 7520 from pot
*** SUMMARY ***
Total pot 7520 | Rake 0 
Board [Td 8h 3c 7s 3d]
Seat 1: srob8075 folded before Flop (didn't bet)
Seat 2: NicilaWCOOP folded before Flop (didn't bet)
Seat 3: mr.DronSemen showed [7c 8c] and won (7520) with two pair, Eights and Sevens
Seat 4: walliwasya folded before Flop (didn't bet)
Seat 5: kimhenry68 folded before Flop (didn't bet)
Seat 6: TACFOUR (button) folded before Flop (didn't bet)
Seat 7: Spaix (small blind) folded on the Flop
Seat 8: casiodk333 (big blind) showed [Jc 8s] and lost with two pair, Eights and Threes
Seat 9: Schwaetzer84 folded before Flop (didn't bet)



PokerStars Hand #132874247470: Tournament #1164585221, $20+$2 USD Hold'em No Limit - Level XI (125/250) - 2015/03/29 22:33:04 CET [2015/03/29 16:33:04 ET]
Table '1164585221 164' 9-max Seat #7 is the button
Seat 1: srob8075 (3865 in chips) 
Seat 2: NicilaWCOOP (14059 in chips) 
Seat 3: mr.DronSemen (20324 in chips) 
Seat 4: walliwasya (15585 in chips) 
Seat 5: kimhenry68 (17570 in chips) 
Seat 6: TACFOUR (10037 in chips) 
Seat 7: Spaix (18605 in chips) 
Seat 8: casiodk333 (8992 in chips) 
Seat 9: Schwaetzer84 (8958 in chips) 
srob8075: posts the ante 30
NicilaWCOOP: posts the ante 30
mr.DronSemen: posts the ante 30
walliwasya: posts the ante 30
kimhenry68: posts the ante 30
TACFOUR: posts the ante 30
Spaix: posts the ante 30
casiodk333: posts the ante 30
Schwaetzer84: posts the ante 30
casiodk333: posts small blind 125
Schwaetzer84: posts big blind 250
*** HOLE CARDS ***
Dealt to casiodk333 [2h 5s]
srob8075: folds 
NicilaWCOOP: folds 
mr.DronSemen: raises 375 to 625
walliwasya: folds 
kimhenry68: calls 625
TACFOUR: folds 
Spaix: folds 
casiodk333: folds 
Schwaetzer84: calls 375
*** FLOP *** [8c 9c 7s]
Schwaetzer84: checks 
mr.DronSemen: bets 875
kimhenry68: calls 875
Schwaetzer84: calls 875
*** TURN *** [8c 9c 7s] [8d]
Schwaetzer84: checks 
mr.DronSemen: checks 
kimhenry68: checks 
*** RIVER *** [8c 9c 7s 8d] [2d]
Schwaetzer84: checks 
mr.DronSemen: bets 1468
kimhenry68: folds 
Schwaetzer84: folds 
Uncalled bet (1468) returned to mr.DronSemen
mr.DronSemen collected 4895 from pot
*** SUMMARY ***
Total pot 4895 | Rake 0 
Board [8c 9c 7s 8d 2d]
Seat 1: srob8075 folded before Flop (didn't bet)
Seat 2: NicilaWCOOP folded before Flop (didn't bet)
Seat 3: mr.DronSemen collected (4895)
Seat 4: walliwasya folded before Flop (didn't bet)
Seat 5: kimhenry68 folded on the River
Seat 6: TACFOUR folded before Flop (didn't bet)
Seat 7: Spaix (button) folded before Flop (didn't bet)
Seat 8: casiodk333 (small blind) folded before Flop
Seat 9: Schwaetzer84 (big blind) folded on the River



PokerStars Hand #132874334567: Tournament #1164585221, $20+$2 USD Hold'em No Limit - Level XI (125/250) - 2015/03/29 22:34:16 CET [2015/03/29 16:34:16 ET]
Table '1164585221 164' 9-max Seat #8 is the button
Seat 1: srob8075 (3835 in chips) 
Seat 2: NicilaWCOOP (14029 in chips) 
Seat 3: mr.DronSemen (23689 in chips) 
Seat 4: walliwasya (15555 in chips) 
Seat 5: kimhenry68 (16040 in chips) 
Seat 6: TACFOUR (10007 in chips) 
Seat 7: Spaix (18575 in chips) 
Seat 8: casiodk333 (8837 in chips) 
Seat 9: Schwaetzer84 (7428 in chips) 
srob8075: posts the ante 30
NicilaWCOOP: posts the ante 30
mr.DronSemen: posts the ante 30
walliwasya: posts the ante 30
kimhenry68: posts the ante 30
TACFOUR: posts the ante 30
Spaix: posts the ante 30
casiodk333: posts the ante 30
Schwaetzer84: posts the ante 30
Schwaetzer84: posts small blind 125
srob8075: posts big blind 250
*** HOLE CARDS ***
Dealt to casiodk333 [Kd Td]
NicilaWCOOP: folds 
mr.DronSemen: raises 250 to 500
walliwasya: folds 
kimhenry68: folds 
TACFOUR: folds 
Spaix: raises 500 to 1000
casiodk333: calls 1000
Schwaetzer84: folds 
srob8075: folds 
mr.DronSemen: calls 500
*** FLOP *** [7s 5c Ks]
mr.DronSemen: checks 
Spaix: checks 
casiodk333: bets 1875
mr.DronSemen: folds 
Spaix: folds 
Uncalled bet (1875) returned to casiodk333
casiodk333 collected 3645 from pot
*** SUMMARY ***
Total pot 3645 | Rake 0 
Board [7s 5c Ks]
Seat 1: srob8075 (big blind) folded before Flop
Seat 2: NicilaWCOOP folded before Flop (didn't bet)
Seat 3: mr.DronSemen folded on the Flop
Seat 4: walliwasya folded before Flop (didn't bet)
Seat 5: kimhenry68 folded before Flop (didn't bet)
Seat 6: TACFOUR folded before Flop (didn't bet)
Seat 7: Spaix folded on the Flop
Seat 8: casiodk333 (button) collected (3645)
Seat 9: Schwaetzer84 (small blind) folded before Flop



PokerStars Hand #132874397879: Tournament #1164585221, $20+$2 USD Hold'em No Limit - Level XI (125/250) - 2015/03/29 22:35:08 CET [2015/03/29 16:35:08 ET]
Table '1164585221 164' 9-max Seat #9 is the button
Seat 1: srob8075 (3555 in chips) 
Seat 2: NicilaWCOOP (13999 in chips) 
Seat 3: mr.DronSemen (22659 in chips) 
Seat 4: walliwasya (15525 in chips) 
Seat 5: kimhenry68 (16010 in chips) 
Seat 6: TACFOUR (9977 in chips) 
Seat 7: Spaix (17545 in chips) 
Seat 8: casiodk333 (11452 in chips) 
Seat 9: Schwaetzer84 (7273 in chips) 
srob8075: posts the ante 30
NicilaWCOOP: posts the ante 30
mr.DronSemen: posts the ante 30
walliwasya: posts the ante 30
kimhenry68: posts the ante 30
TACFOUR: posts the ante 30
Spaix: posts the ante 30
casiodk333: posts the ante 30
Schwaetzer84: posts the ante 30
srob8075: posts small blind 125
NicilaWCOOP: posts big blind 250
*** HOLE CARDS ***
Dealt to casiodk333 [Ad 3h]
mr.DronSemen: folds 
walliwasya: folds 
kimhenry68: folds 
TACFOUR: folds 
Spaix: folds 
casiodk333: folds 
Schwaetzer84: folds 
srob8075: folds 
Uncalled bet (125) returned to NicilaWCOOP
NicilaWCOOP collected 520 from pot
NicilaWCOOP: doesn't show hand 
*** SUMMARY ***
Total pot 520 | Rake 0 
Seat 1: srob8075 (small blind) folded before Flop
Seat 2: NicilaWCOOP (big blind) collected (520)
Seat 3: mr.DronSemen folded before Flop (didn't bet)
Seat 4: walliwasya folded before Flop (didn't bet)
Seat 5: kimhenry68 folded before Flop (didn't bet)
Seat 6: TACFOUR folded before Flop (didn't bet)
Seat 7: Spaix folded before Flop (didn't bet)
Seat 8: casiodk333 folded before Flop (didn't bet)
Seat 9: Schwaetzer84 (button) folded before Flop (didn't bet)



PokerStars Hand #132874418977: Tournament #1164585221, $20+$2 USD Hold'em No Limit - Level XI (125/250) - 2015/03/29 22:35:25 CET [2015/03/29 16:35:25 ET]
Table '1164585221 164' 9-max Seat #1 is the button
Seat 1: srob8075 (3400 in chips) 
Seat 2: NicilaWCOOP (14364 in chips) 
Seat 3: mr.DronSemen (22629 in chips) 
Seat 4: walliwasya (15495 in chips) 
Seat 5: kimhenry68 (15980 in chips) 
Seat 6: TACFOUR (9947 in chips) 
Seat 7: Spaix (17515 in chips) 
Seat 8: casiodk333 (11422 in chips) 
Seat 9: Schwaetzer84 (7243 in chips) 
srob8075: posts the ante 30
NicilaWCOOP: posts the ante 30
mr.DronSemen: posts the ante 30
walliwasya: posts the ante 30
kimhenry68: posts the ante 30
TACFOUR: posts the ante 30
Spaix: posts the ante 30
casiodk333: posts the ante 30
Schwaetzer84: posts the ante 30
NicilaWCOOP: posts small blind 125
mr.DronSemen: posts big blind 250
*** HOLE CARDS ***
Dealt to casiodk333 [4s Ah]
walliwasya: folds 
kimhenry68: folds 
TACFOUR: folds 
Spaix: folds 
casiodk333: folds 
Schwaetzer84: folds 
srob8075: raises 325 to 575
NicilaWCOOP: folds 
mr.DronSemen: raises 22024 to 22599 and is all-in
srob8075: calls 2795 and is all-in
Uncalled bet (19229) returned to mr.DronSemen
*** FLOP *** [Qh Ks 4h]
*** TURN *** [Qh Ks 4h] [Qd]
*** RIVER *** [Qh Ks 4h Qd] [5s]
*** SHOW DOWN ***
mr.DronSemen: shows [7c 7d] (two pair, Queens and Sevens)
srob8075: shows [8c Ac] (a pair of Queens)
mr.DronSemen collected 7135 from pot
*** SUMMARY ***
Total pot 7135 | Rake 0 
Board [Qh Ks 4h Qd 5s]
Seat 1: srob8075 (button) showed [8c Ac] and lost with a pair of Queens
Seat 2: NicilaWCOOP (small blind) folded before Flop
Seat 3: mr.DronSemen (big blind) showed [7c 7d] and won (7135) with two pair, Queens and Sevens
Seat 4: walliwasya folded before Flop (didn't bet)
Seat 5: kimhenry68 folded before Flop (didn't bet)
Seat 6: TACFOUR folded before Flop (didn't bet)
Seat 7: Spaix folded before Flop (didn't bet)
Seat 8: casiodk333 folded before Flop (didn't bet)
Seat 9: Schwaetzer84 folded before Flop (didn't bet)



PokerStars Hand #132874537819: Tournament #1164585221, $20+$2 USD Hold'em No Limit - Level XI (125/250) - 2015/03/29 22:37:07 CET [2015/03/29 16:37:07 ET]
Table '1164585221 1854' 9-max Seat #7 is the button
Seat 1: msad85 (10919 in chips) 
Seat 2: Vanderxd (19300 in chips) 
Seat 3: marcel.d420 (9045 in chips) 
Seat 4: casiodk333 (11392 in chips) 
Seat 5: novalinho (15036 in chips) 
Seat 6: jaybot1 (2516 in chips) 
Seat 7: merkurstar (17512 in chips) 
Seat 8: hustla16 (13735 in chips) 
Seat 9: Liam046 (17981 in chips) 
msad85: posts the ante 30
Vanderxd: posts the ante 30
marcel.d420: posts the ante 30
casiodk333: posts the ante 30
novalinho: posts the ante 30
jaybot1: posts the ante 30
merkurstar: posts the ante 30
hustla16: posts the ante 30
Liam046: posts the ante 30
hustla16: posts small blind 125
Liam046: posts big blind 250
*** HOLE CARDS ***
Dealt to casiodk333 [Kh 3c]
msad85: folds 
Vanderxd: folds 
marcel.d420: raises 250 to 500
casiodk333: folds 
novalinho: folds 
jaybot1: folds 
merkurstar: folds 
hustla16: folds 
Liam046: calls 250
*** FLOP *** [Qs 6d 8h]
Liam046: checks 
marcel.d420: checks 
*** TURN *** [Qs 6d 8h] [2s]
Liam046: bets 1250
marcel.d420: raises 1250 to 2500
Liam046: folds 
Uncalled bet (1250) returned to marcel.d420
marcel.d420 collected 3895 from pot
*** SUMMARY ***
Total pot 3895 | Rake 0 
Board [Qs 6d 8h 2s]
Seat 1: msad85 folded before Flop (didn't bet)
Seat 2: Vanderxd folded before Flop (didn't bet)
Seat 3: marcel.d420 collected (3895)
Seat 4: casiodk333 folded before Flop (didn't bet)
Seat 5: novalinho folded before Flop (didn't bet)
Seat 6: jaybot1 folded before Flop (didn't bet)
Seat 7: merkurstar (button) folded before Flop (didn't bet)
Seat 8: hustla16 (small blind) folded before Flop
Seat 9: Liam046 (big blind) folded on the Turn



PokerStars Hand #132874595656: Tournament #1164585221, $20+$2 USD Hold'em No Limit - Level XI (125/250) - 2015/03/29 22:37:54 CET [2015/03/29 16:37:54 ET]
Table '1164585221 1854' 9-max Seat #8 is the button
Seat 1: msad85 (10889 in chips) 
Seat 2: Vanderxd (19270 in chips) 
Seat 3: marcel.d420 (11160 in chips) 
Seat 4: casiodk333 (11362 in chips) 
Seat 5: novalinho (15006 in chips) 
Seat 6: jaybot1 (2486 in chips) 
Seat 7: merkurstar (17482 in chips) 
Seat 8: hustla16 (13580 in chips) 
Seat 9: Liam046 (16201 in chips) 
msad85: posts the ante 30
Vanderxd: posts the ante 30
marcel.d420: posts the ante 30
casiodk333: posts the ante 30
novalinho: posts the ante 30
jaybot1: posts the ante 30
merkurstar: posts the ante 30
hustla16: posts the ante 30
Liam046: posts the ante 30
Liam046: posts small blind 125
msad85: posts big blind 250
*** HOLE CARDS ***
Dealt to casiodk333 [6s Kh]
Vanderxd: folds 
marcel.d420: calls 250
casiodk333: folds 
novalinho: folds 
jaybot1: folds 
merkurstar: folds 
hustla16: raises 250 to 500
Liam046: folds 
msad85: folds 
marcel.d420: calls 250
*** FLOP *** [Ah Qc Ks]
marcel.d420: checks 
hustla16: checks 
*** TURN *** [Ah Qc Ks] [Qd]
marcel.d420: checks 
hustla16: checks 
*** RIVER *** [Ah Qc Ks Qd] [4d]
marcel.d420: bets 500
hustla16: calls 500
*** SHOW DOWN ***
marcel.d420: shows [8s Qs] (three of a kind, Queens)
hustla16: mucks hand 
marcel.d420 collected 2645 from pot
*** SUMMARY ***
Total pot 2645 | Rake 0 
Board [Ah Qc Ks Qd 4d]
Seat 1: msad85 (big blind) folded before Flop
Seat 2: Vanderxd folded before Flop (didn't bet)
Seat 3: marcel.d420 showed [8s Qs] and won (2645) with three of a kind, Queens
Seat 4: casiodk333 folded before Flop (didn't bet)
Seat 5: novalinho folded before Flop (didn't bet)
Seat 6: jaybot1 folded before Flop (didn't bet)
Seat 7: merkurstar folded before Flop (didn't bet)
Seat 8: hustla16 (button) mucked [Js Ac]
Seat 9: Liam046 (small blind) folded before Flop



PokerStars Hand #132874687738: Tournament #1164585221, $20+$2 USD Hold'em No Limit - Level XI (125/250) - 2015/03/29 22:39:12 CET [2015/03/29 16:39:12 ET]
Table '1164585221 1854' 9-max Seat #9 is the button
Seat 1: msad85 (10609 in chips) 
Seat 2: Vanderxd (19240 in chips) 
Seat 3: marcel.d420 (12775 in chips) 
Seat 4: casiodk333 (11332 in chips) 
Seat 5: novalinho (14976 in chips) 
Seat 6: jaybot1 (2456 in chips) 
Seat 7: merkurstar (17452 in chips) 
Seat 8: hustla16 (12550 in chips) 
Seat 9: Liam046 (16046 in chips) 
msad85: posts the ante 30
Vanderxd: posts the ante 30
marcel.d420: posts the ante 30
casiodk333: posts the ante 30
novalinho: posts the ante 30
jaybot1: posts the ante 30
merkurstar: posts the ante 30
hustla16: posts the ante 30
Liam046: posts the ante 30
msad85: posts small blind 125
Vanderxd: posts big blind 250
*** HOLE CARDS ***
Dealt to casiodk333 [Ah 3s]
marcel.d420: folds 
casiodk333: folds 
novalinho: folds 
jaybot1: folds 
merkurstar: folds 
hustla16: folds 
Liam046: calls 250
msad85: calls 125
Vanderxd: checks 
*** FLOP *** [Qh 3d 7d]
msad85: checks 
Vanderxd: checks 
Liam046 is connected 
Liam046: bets 500
msad85: folds 
Vanderxd: folds 
Uncalled bet (500) returned to Liam046
Liam046 collected 1020 from pot
Liam046: doesn't show hand 
*** SUMMARY ***
Total pot 1020 | Rake 0 
Board [Qh 3d 7d]
Seat 1: msad85 (small blind) folded on the Flop
Seat 2: Vanderxd (big blind) folded on the Flop
Seat 3: marcel.d420 folded before Flop (didn't bet)
Seat 4: casiodk333 folded before Flop (didn't bet)
Seat 5: novalinho folded before Flop (didn't bet)
Seat 6: jaybot1 folded before Flop (didn't bet)
Seat 7: merkurstar folded before Flop (didn't bet)
Seat 8: hustla16 folded before Flop (didn't bet)
Seat 9: Liam046 (button) collected (1020)



PokerStars Hand #132874791160: Tournament #1164585221, $20+$2 USD Hold'em No Limit - Level XI (125/250) - 2015/03/29 22:40:38 CET [2015/03/29 16:40:38 ET]
Table '1164585221 1854' 9-max Seat #1 is the button
Seat 1: msad85 (10329 in chips) 
Seat 2: Vanderxd (18960 in chips) 
Seat 3: marcel.d420 (12745 in chips) 
Seat 4: casiodk333 (11302 in chips) 
Seat 5: novalinho (14946 in chips) 
Seat 6: jaybot1 (2426 in chips) 
Seat 7: merkurstar (17422 in chips) 
Seat 8: hustla16 (12520 in chips) 
Seat 9: Liam046 (16786 in chips) 
msad85: posts the ante 30
Vanderxd: posts the ante 30
marcel.d420: posts the ante 30
casiodk333: posts the ante 30
novalinho: posts the ante 30
jaybot1: posts the ante 30
merkurstar: posts the ante 30
hustla16: posts the ante 30
Liam046: posts the ante 30
Vanderxd: posts small blind 125
marcel.d420: posts big blind 250
*** HOLE CARDS ***
Dealt to casiodk333 [5s Ts]
casiodk333: folds 
novalinho: folds 
jaybot1: raises 2146 to 2396 and is all-in
merkurstar: folds 
hustla16: folds 
Liam046: folds 
msad85: folds 
Vanderxd: folds 
marcel.d420: folds 
Uncalled bet (2146) returned to jaybot1
jaybot1 collected 895 from pot
jaybot1: doesn't show hand 
*** SUMMARY ***
Total pot 895 | Rake 0 
Seat 1: msad85 (button) folded before Flop (didn't bet)
Seat 2: Vanderxd (small blind) folded before Flop
Seat 3: marcel.d420 (big blind) folded before Flop
Seat 4: casiodk333 folded before Flop (didn't bet)
Seat 5: novalinho folded before Flop (didn't bet)
Seat 6: jaybot1 collected (895)
Seat 7: merkurstar folded before Flop (didn't bet)
Seat 8: hustla16 folded before Flop (didn't bet)
Seat 9: Liam046 folded before Flop (didn't bet)



PokerStars Hand #132874824685: Tournament #1164585221, $20+$2 USD Hold'em No Limit - Level XI (125/250) - 2015/03/29 22:41:06 CET [2015/03/29 16:41:06 ET]
Table '1164585221 1854' 9-max Seat #2 is the button
Seat 1: msad85 (10299 in chips) 
Seat 2: Vanderxd (18805 in chips) 
Seat 3: marcel.d420 (12465 in chips) 
Seat 4: casiodk333 (11272 in chips) 
Seat 5: novalinho (14916 in chips) 
Seat 6: jaybot1 (3041 in chips) 
Seat 7: merkurstar (17392 in chips) 
Seat 8: hustla16 (12490 in chips) 
Seat 9: Liam046 (16756 in chips) 
msad85: posts the ante 30
Vanderxd: posts the ante 30
marcel.d420: posts the ante 30
casiodk333: posts the ante 30
novalinho: posts the ante 30
jaybot1: posts the ante 30
merkurstar: posts the ante 30
hustla16: posts the ante 30
Liam046: posts the ante 30
marcel.d420: posts small blind 125
casiodk333: posts big blind 250
*** HOLE CARDS ***
Dealt to casiodk333 [8d Jd]
novalinho: folds 
jaybot1: folds 
merkurstar: raises 456 to 706
hustla16: folds 
Liam046: calls 706
msad85: folds 
Vanderxd: folds 
marcel.d420: calls 581
casiodk333: calls 456
*** FLOP *** [8h 9s 4d]
marcel.d420: bets 250
casiodk333: calls 250
merkurstar: calls 250
Liam046: calls 250
*** TURN *** [8h 9s 4d] [9d]
marcel.d420: bets 250
casiodk333: raises 1250 to 1500
merkurstar: folds 
Liam046: folds 
marcel.d420: calls 1250
*** RIVER *** [8h 9s 4d 9d] [8s]
marcel.d420: checks 
casiodk333: bets 2222
marcel.d420: calls 2222
*** SHOW DOWN ***
casiodk333: shows [8d Jd] (a full house, Eights full of Nines)
marcel.d420: mucks hand 
casiodk333 collected 11538 from pot
*** SUMMARY ***
Total pot 11538 | Rake 0 
Board [8h 9s 4d 9d 8s]
Seat 1: msad85 folded before Flop (didn't bet)
Seat 2: Vanderxd (button) folded before Flop (didn't bet)
Seat 3: marcel.d420 (small blind) mucked [Qh Qd]
Seat 4: casiodk333 (big blind) showed [8d Jd] and won (11538) with a full house, Eights full of Nines
Seat 5: novalinho folded before Flop (didn't bet)
Seat 6: jaybot1 folded before Flop (didn't bet)
Seat 7: merkurstar folded on the Turn
Seat 8: hustla16 folded before Flop (didn't bet)
Seat 9: Liam046 folded on the Turn



PokerStars Hand #132874921283: Tournament #1164585221, $20+$2 USD Hold'em No Limit - Level XII (150/300) - 2015/03/29 22:42:26 CET [2015/03/29 16:42:26 ET]
Table '1164585221 1854' 9-max Seat #3 is the button
Seat 1: msad85 (10269 in chips) 
Seat 2: Vanderxd (18775 in chips) 
Seat 3: marcel.d420 (7757 in chips) 
Seat 4: casiodk333 (18102 in chips) 
Seat 5: novalinho (14886 in chips) 
Seat 6: jaybot1 (3011 in chips) 
Seat 7: merkurstar (16406 in chips) 
Seat 8: hustla16 (12460 in chips) 
Seat 9: Liam046 (15770 in chips) 
msad85: posts the ante 40
Vanderxd: posts the ante 40
marcel.d420: posts the ante 40
casiodk333: posts the ante 40
novalinho: posts the ante 40
jaybot1: posts the ante 40
merkurstar: posts the ante 40
hustla16: posts the ante 40
Liam046: posts the ante 40
casiodk333: posts small blind 150
novalinho: posts big blind 300
*** HOLE CARDS ***
Dealt to casiodk333 [Ts 4d]
jaybot1: folds 
merkurstar: raises 566 to 866
hustla16: folds 
Liam046: folds 
msad85: folds 
Vanderxd: calls 866
marcel.d420: folds 
casiodk333: folds 
novalinho: folds 
*** FLOP *** [Jh Ac 7s]
merkurstar: bets 1321
Vanderxd: folds 
Uncalled bet (1321) returned to merkurstar
merkurstar collected 2542 from pot
merkurstar: doesn't show hand 
*** SUMMARY ***
Total pot 2542 | Rake 0 
Board [Jh Ac 7s]
Seat 1: msad85 folded before Flop (didn't bet)
Seat 2: Vanderxd folded on the Flop
Seat 3: marcel.d420 (button) folded before Flop (didn't bet)
Seat 4: casiodk333 (small blind) folded before Flop
Seat 5: novalinho (big blind) folded before Flop
Seat 6: jaybot1 folded before Flop (didn't bet)
Seat 7: merkurstar collected (2542)
Seat 8: hustla16 folded before Flop (didn't bet)
Seat 9: Liam046 folded before Flop (didn't bet)



PokerStars Hand #132874951117: Tournament #1164585221, $20+$2 USD Hold'em No Limit - Level XII (150/300) - 2015/03/29 22:42:51 CET [2015/03/29 16:42:51 ET]
Table '1164585221 1854' 9-max Seat #4 is the button
Seat 1: msad85 (10229 in chips) 
Seat 2: Vanderxd (17869 in chips) 
Seat 3: marcel.d420 (7717 in chips) 
Seat 4: casiodk333 (17912 in chips) 
Seat 5: novalinho (14546 in chips) 
Seat 6: jaybot1 (2971 in chips) 
Seat 7: merkurstar (18042 in chips) 
Seat 8: hustla16 (12420 in chips) 
Seat 9: Liam046 (15730 in chips) 
msad85: posts the ante 40
Vanderxd: posts the ante 40
marcel.d420: posts the ante 40
casiodk333: posts the ante 40
novalinho: posts the ante 40
jaybot1: posts the ante 40
merkurstar: posts the ante 40
hustla16: posts the ante 40
Liam046: posts the ante 40
novalinho: posts small blind 150
jaybot1: posts big blind 300
*** HOLE CARDS ***
Dealt to casiodk333 [Js 3s]
merkurstar: calls 300
hustla16: calls 300
Liam046: folds 
msad85: folds 
Vanderxd: folds 
marcel.d420: folds 
casiodk333: folds 
novalinho: folds 
jaybot1: checks 
*** FLOP *** [3h 3c Kh]
jaybot1: checks 
merkurstar: checks 
hustla16: bets 600
jaybot1: folds 
merkurstar: folds 
Uncalled bet (600) returned to hustla16
hustla16 collected 1410 from pot
*** SUMMARY ***
Total pot 1410 | Rake 0 
Board [3h 3c Kh]
Seat 1: msad85 folded before Flop (didn't bet)
Seat 2: Vanderxd folded before Flop (didn't bet)
Seat 3: marcel.d420 folded before Flop (didn't bet)
Seat 4: casiodk333 (button) folded before Flop (didn't bet)
Seat 5: novalinho (small blind) folded before Flop
Seat 6: jaybot1 (big blind) folded on the Flop
Seat 7: merkurstar folded on the Flop
Seat 8: hustla16 collected (1410)
Seat 9: Liam046 folded before Flop (didn't bet)



PokerStars Hand #132875014264: Tournament #1164585221, $20+$2 USD Hold'em No Limit - Level XII (150/300) - 2015/03/29 22:43:42 CET [2015/03/29 16:43:42 ET]
Table '1164585221 1854' 9-max Seat #5 is the button
Seat 1: msad85 (10189 in chips) 
Seat 2: Vanderxd (17829 in chips) 
Seat 3: marcel.d420 (7677 in chips) 
Seat 4: casiodk333 (17872 in chips) 
Seat 5: novalinho (14356 in chips) 
Seat 6: jaybot1 (2631 in chips) 
Seat 7: merkurstar (17702 in chips) 
Seat 8: hustla16 (13490 in chips) 
Seat 9: DB169 (4676 in chips) 
msad85: posts the ante 40
Vanderxd: posts the ante 40
marcel.d420: posts the ante 40
casiodk333: posts the ante 40
novalinho: posts the ante 40
jaybot1: posts the ante 40
merkurstar: posts the ante 40
hustla16: posts the ante 40
DB169: posts the ante 40
jaybot1: posts small blind 150
merkurstar: posts big blind 300
*** HOLE CARDS ***
Dealt to casiodk333 [6d 2c]
hustla16: folds 
DB169: folds 
msad85: folds 
Vanderxd: folds 
marcel.d420: calls 300
casiodk333: folds 
novalinho: folds 
jaybot1: raises 2291 to 2591 and is all-in
merkurstar: folds 
marcel.d420: calls 2291
*** FLOP *** [Qh Ad 4s]
*** TURN *** [Qh Ad 4s] [3c]
*** RIVER *** [Qh Ad 4s 3c] [6c]
*** SHOW DOWN ***
jaybot1: shows [Kd 8d] (high card Ace)
marcel.d420: shows [Ac 8h] (a pair of Aces)
marcel.d420 collected 5842 from pot
jaybot1 finished the tournament in 39316th place
*** SUMMARY ***
Total pot 5842 | Rake 0 
Board [Qh Ad 4s 3c 6c]
Seat 1: msad85 folded before Flop (didn't bet)
Seat 2: Vanderxd folded before Flop (didn't bet)
Seat 3: marcel.d420 showed [Ac 8h] and won (5842) with a pair of Aces
Seat 4: casiodk333 folded before Flop (didn't bet)
Seat 5: novalinho (button) folded before Flop (didn't bet)
Seat 6: jaybot1 (small blind) showed [Kd 8d] and lost with high card Ace
Seat 7: merkurstar (big blind) folded before Flop
Seat 8: hustla16 folded before Flop (didn't bet)
Seat 9: DB169 folded before Flop (didn't bet)



PokerStars Hand #132875068736: Tournament #1164585221, $20+$2 USD Hold'em No Limit - Level XII (150/300) - 2015/03/29 22:44:27 CET [2015/03/29 16:44:27 ET]
Table '1164585221 1854' 9-max Seat #7 is the button
Seat 1: msad85 (10149 in chips) 
Seat 2: Vanderxd (17789 in chips) 
Seat 3: marcel.d420 (10888 in chips) 
Seat 4: casiodk333 (17832 in chips) 
Seat 5: novalinho (14316 in chips) 
Seat 6: *8Vejon8* (25095 in chips) 
Seat 7: merkurstar (17362 in chips) 
Seat 8: hustla16 (13450 in chips) 
Seat 9: DB169 (4636 in chips) 
msad85: posts the ante 40
Vanderxd: posts the ante 40
marcel.d420: posts the ante 40
casiodk333: posts the ante 40
novalinho: posts the ante 40
*8Vejon8*: posts the ante 40
merkurstar: posts the ante 40
hustla16: posts the ante 40
DB169: posts the ante 40
hustla16: posts small blind 150
DB169: posts big blind 300
*** HOLE CARDS ***
Dealt to casiodk333 [6d Ts]
msad85: folds 
Vanderxd: folds 
marcel.d420: folds 
casiodk333: folds 
novalinho: raises 450 to 750
*8Vejon8*: folds 
merkurstar: folds 
hustla16: folds 
DB169: calls 450
*** FLOP *** [6s 3s 9h]
DB169: checks 
novalinho: checks 
*** TURN *** [6s 3s 9h] [2d]
DB169: bets 900
novalinho: folds 
Uncalled bet (900) returned to DB169
DB169 collected 2010 from pot
DB169: doesn't show hand 
*** SUMMARY ***
Total pot 2010 | Rake 0 
Board [6s 3s 9h 2d]
Seat 1: msad85 folded before Flop (didn't bet)
Seat 2: Vanderxd folded before Flop (didn't bet)
Seat 3: marcel.d420 folded before Flop (didn't bet)
Seat 4: casiodk333 folded before Flop (didn't bet)
Seat 5: novalinho folded on the Turn
Seat 6: *8Vejon8* folded before Flop (didn't bet)
Seat 7: merkurstar (button) folded before Flop (didn't bet)
Seat 8: hustla16 (small blind) folded before Flop
Seat 9: DB169 (big blind) collected (2010)



PokerStars Hand #132875125881: Tournament #1164585221, $20+$2 USD Hold'em No Limit - Level XII (150/300) - 2015/03/29 22:45:14 CET [2015/03/29 16:45:14 ET]
Table '1164585221 1854' 9-max Seat #8 is the button
Seat 1: msad85 (10109 in chips) 
Seat 2: Vanderxd (17749 in chips) 
Seat 3: marcel.d420 (10848 in chips) 
Seat 4: casiodk333 (17792 in chips) 
Seat 5: novalinho (13526 in chips) 
Seat 6: *8Vejon8* (25055 in chips) 
Seat 7: merkurstar (17322 in chips) 
Seat 8: hustla16 (13260 in chips) 
Seat 9: DB169 (5856 in chips) 
msad85: posts the ante 40
Vanderxd: posts the ante 40
marcel.d420: posts the ante 40
casiodk333: posts the ante 40
novalinho: posts the ante 40
*8Vejon8*: posts the ante 40
merkurstar: posts the ante 40
hustla16: posts the ante 40
DB169: posts the ante 40
DB169: posts small blind 150
msad85: posts big blind 300
*** HOLE CARDS ***
Dealt to casiodk333 [Qh 5c]
Vanderxd: folds 
marcel.d420: calls 300
casiodk333: folds 
novalinho: folds 
*8Vejon8*: folds 
merkurstar: folds 
hustla16: raises 300 to 600
DB169: folds 
msad85: calls 300
marcel.d420: calls 300
*** FLOP *** [Kc 2h 5h]
msad85: checks 
marcel.d420: checks 
hustla16: checks 
*** TURN *** [Kc 2h 5h] [8d]
msad85: checks 
marcel.d420: bets 300
hustla16: calls 300
msad85: folds 
*** RIVER *** [Kc 2h 5h 8d] [9h]
marcel.d420: bets 300
hustla16: calls 300
*** SHOW DOWN ***
marcel.d420: shows [Ks Ts] (a pair of Kings)
hustla16: mucks hand 
marcel.d420 collected 3510 from pot
*** SUMMARY ***
Total pot 3510 | Rake 0 
Board [Kc 2h 5h 8d 9h]
Seat 1: msad85 (big blind) folded on the Turn
Seat 2: Vanderxd folded before Flop (didn't bet)
Seat 3: marcel.d420 showed [Ks Ts] and won (3510) with a pair of Kings
Seat 4: casiodk333 folded before Flop (didn't bet)
Seat 5: novalinho folded before Flop (didn't bet)
Seat 6: *8Vejon8* folded before Flop (didn't bet)
Seat 7: merkurstar folded before Flop (didn't bet)
Seat 8: hustla16 (button) mucked [Ah Td]
Seat 9: DB169 (small blind) folded before Flop



PokerStars Hand #132875242429: Tournament #1164585221, $20+$2 USD Hold'em No Limit - Level XII (150/300) - 2015/03/29 22:46:50 CET [2015/03/29 16:46:50 ET]
Table '1164585221 1854' 9-max Seat #9 is the button
Seat 1: msad85 (9469 in chips) 
Seat 2: Vanderxd (17709 in chips) 
Seat 3: marcel.d420 (13118 in chips) 
Seat 4: casiodk333 (17752 in chips) 
Seat 5: novalinho (13486 in chips) 
Seat 6: *8Vejon8* (25015 in chips) 
Seat 7: merkurstar (17282 in chips) 
Seat 8: hustla16 (12020 in chips) 
Seat 9: DB169 (5666 in chips) 
msad85: posts the ante 40
Vanderxd: posts the ante 40
marcel.d420: posts the ante 40
casiodk333: posts the ante 40
novalinho: posts the ante 40
*8Vejon8*: posts the ante 40
merkurstar: posts the ante 40
hustla16: posts the ante 40
DB169: posts the ante 40
msad85: posts small blind 150
Vanderxd: posts big blind 300
*** HOLE CARDS ***
Dealt to casiodk333 [5h Jh]
marcel.d420: folds 
casiodk333: folds 
novalinho: folds 
*8Vejon8*: folds 
merkurstar: folds 
hustla16: folds 
DB169: raises 600 to 900
msad85: folds 
Vanderxd: calls 600
*** FLOP *** [2d 5c 2c]
Vanderxd: checks 
DB169: bets 900
Vanderxd: folds 
Uncalled bet (900) returned to DB169
DB169 collected 2310 from pot
DB169: doesn't show hand 
*** SUMMARY ***
Total pot 2310 | Rake 0 
Board [2d 5c 2c]
Seat 1: msad85 (small blind) folded before Flop
Seat 2: Vanderxd (big blind) folded on the Flop
Seat 3: marcel.d420 folded before Flop (didn't bet)
Seat 4: casiodk333 folded before Flop (didn't bet)
Seat 5: novalinho folded before Flop (didn't bet)
Seat 6: *8Vejon8* folded before Flop (didn't bet)
Seat 7: merkurstar folded before Flop (didn't bet)
Seat 8: hustla16 folded before Flop (didn't bet)
Seat 9: DB169 (button) collected (2310)



PokerStars Hand #132875303408: Tournament #1164585221, $20+$2 USD Hold'em No Limit - Level XII (150/300) - 2015/03/29 22:47:40 CET [2015/03/29 16:47:40 ET]
Table '1164585221 1854' 9-max Seat #1 is the button
Seat 1: msad85 (9279 in chips) 
Seat 2: Vanderxd (16769 in chips) 
Seat 3: marcel.d420 (13078 in chips) 
Seat 4: casiodk333 (17712 in chips) 
Seat 5: novalinho (13446 in chips) 
Seat 6: *8Vejon8* (24975 in chips) 
Seat 7: merkurstar (17242 in chips) 
Seat 8: hustla16 (11980 in chips) 
Seat 9: DB169 (7036 in chips) 
msad85: posts the ante 40
Vanderxd: posts the ante 40
marcel.d420: posts the ante 40
casiodk333: posts the ante 40
novalinho: posts the ante 40
*8Vejon8*: posts the ante 40
merkurstar: posts the ante 40
hustla16: posts the ante 40
DB169: posts the ante 40
Vanderxd: posts small blind 150
marcel.d420: posts big blind 300
*** HOLE CARDS ***
Dealt to casiodk333 [Qd Jc]
casiodk333: raises 366 to 666
novalinho: folds 
*8Vejon8*: folds 
merkurstar: folds 
hustla16: folds 
DB169: calls 666
msad85: folds 
Vanderxd: folds 
marcel.d420: folds 
*** FLOP *** [5c Kc Qh]
casiodk333: bets 1111
DB169: calls 1111
*** TURN *** [5c Kc Qh] [Qs]
casiodk333: bets 2222
DB169: raises 2222 to 4444
casiodk333: raises 2222 to 6666
DB169: calls 775 and is all-in
Uncalled bet (1447) returned to casiodk333
*** RIVER *** [5c Kc Qh Qs] [8h]
*** SHOW DOWN ***
casiodk333: shows [Qd Jc] (three of a kind, Queens)
DB169: shows [Td Kh] (two pair, Kings and Queens)
casiodk333 collected 14802 from pot
DB169 finished the tournament in 38062nd place
*** SUMMARY ***
Total pot 14802 | Rake 0 
Board [5c Kc Qh Qs 8h]
Seat 1: msad85 (button) folded before Flop (didn't bet)
Seat 2: Vanderxd (small blind) folded before Flop
Seat 3: marcel.d420 (big blind) folded before Flop
Seat 4: casiodk333 showed [Qd Jc] and won (14802) with three of a kind, Queens
Seat 5: novalinho folded before Flop (didn't bet)
Seat 6: *8Vejon8* folded before Flop (didn't bet)
Seat 7: merkurstar folded before Flop (didn't bet)
Seat 8: hustla16 folded before Flop (didn't bet)
Seat 9: DB169 showed [Td Kh] and lost with two pair, Kings and Queens



PokerStars Hand #132875381111: Tournament #1164585221, $20+$2 USD Hold'em No Limit - Level XII (150/300) - 2015/03/29 22:48:45 CET [2015/03/29 16:48:45 ET]
Table '1164585221 3130' 9-max Seat #9 is the button
Seat 1: ApollonK (11919 in chips) 
Seat 2: calibra1967 (25988 in chips) 
Seat 3: Czaaaar (15262 in chips) 
Seat 4: fmlx (7098 in chips) 
Seat 5: casiodk333 (25478 in chips) 
Seat 6: derek03r (20520 in chips) 
Seat 7: wvoron81 (14025 in chips) 
Seat 8: sherban80 (9337 in chips) 
Seat 9: mausiii87 (5923 in chips) 
ApollonK: posts the ante 40
calibra1967: posts the ante 40
Czaaaar: posts the ante 40
fmlx: posts the ante 40
casiodk333: posts the ante 40
derek03r: posts the ante 40
wvoron81: posts the ante 40
sherban80: posts the ante 40
mausiii87: posts the ante 40
ApollonK: posts small blind 150
calibra1967: posts big blind 300
*** HOLE CARDS ***
Dealt to casiodk333 [2h Kd]
calibra1967 said, "great donk"
Czaaaar: folds 
fmlx: folds 
casiodk333: folds 
derek03r: raises 600 to 900
wvoron81: folds 
casiodk333 said, "LOL"
calibra1967 said, "haha"
sherban80: folds 
mausiii87: raises 4983 to 5883 and is all-in
ApollonK: folds 
calibra1967: folds 
derek03r: folds 
Uncalled bet (4983) returned to mausiii87
mausiii87 collected 2610 from pot
mausiii87: doesn't show hand 
calibra1967 said, "you are funny back to youre playmobil now"
*** SUMMARY ***
Total pot 2610 | Rake 0 
Seat 1: ApollonK (small blind) folded before Flop
Seat 2: calibra1967 (big blind) folded before Flop
Seat 3: Czaaaar folded before Flop (didn't bet)
Seat 4: fmlx folded before Flop (didn't bet)
Seat 5: casiodk333 folded before Flop (didn't bet)
Seat 6: derek03r folded before Flop
Seat 7: wvoron81 folded before Flop (didn't bet)
Seat 8: sherban80 folded before Flop (didn't bet)
Seat 9: mausiii87 (button) collected (2610)



PokerStars Hand #132875455123: Tournament #1164585221, $20+$2 USD Hold'em No Limit - Level XII (150/300) - 2015/03/29 22:49:47 CET [2015/03/29 16:49:47 ET]
Table '1164585221 3130' 9-max Seat #1 is the button
Seat 1: ApollonK (11729 in chips) 
Seat 2: calibra1967 (25648 in chips) 
Seat 3: Czaaaar (15222 in chips) 
Seat 4: fmlx (7058 in chips) 
Seat 5: casiodk333 (25438 in chips) 
Seat 6: derek03r (19580 in chips) 
Seat 7: wvoron81 (13985 in chips) 
Seat 8: sherban80 (9297 in chips) 
Seat 9: mausiii87 (7593 in chips) 
ApollonK: posts the ante 40
calibra1967: posts the ante 40
Czaaaar: posts the ante 40
fmlx: posts the ante 40
casiodk333: posts the ante 40
derek03r: posts the ante 40
wvoron81: posts the ante 40
sherban80: posts the ante 40
mausiii87: posts the ante 40
calibra1967: posts small blind 150
Czaaaar: posts big blind 300
*** HOLE CARDS ***
Dealt to casiodk333 [7s Kh]
fmlx: folds 
casiodk333: folds 
derek03r: folds 
wvoron81: raises 450 to 750
sherban80: folds 
calibra1967 said, ":'("
mausiii87: calls 750
ApollonK: folds 
calibra1967: folds 
Czaaaar: folds 
*** FLOP *** [5c 9s 5h]
wvoron81: checks 
mausiii87: bets 1200
wvoron81: calls 1200
*** TURN *** [5c 9s 5h] [Ts]
wvoron81: checks 
mausiii87: bets 5603 and is all-in
wvoron81: calls 5603
*** RIVER *** [5c 9s 5h Ts] [Tc]
*** SHOW DOWN ***
wvoron81: shows [9d 9h] (a full house, Nines full of Tens)
mausiii87: shows [6h 6s] (two pair, Tens and Sixes)
wvoron81 collected 15916 from pot
mausiii87 finished the tournament in 37391st place
*** SUMMARY ***
Total pot 15916 | Rake 0 
Board [5c 9s 5h Ts Tc]
Seat 1: ApollonK (button) folded before Flop (didn't bet)
Seat 2: calibra1967 (small blind) folded before Flop
Seat 3: Czaaaar (big blind) folded before Flop
Seat 4: fmlx folded before Flop (didn't bet)
Seat 5: casiodk333 folded before Flop (didn't bet)
Seat 6: derek03r folded before Flop (didn't bet)
Seat 7: wvoron81 showed [9d 9h] and won (15916) with a full house, Nines full of Tens
Seat 8: sherban80 folded before Flop (didn't bet)
Seat 9: mausiii87 showed [6h 6s] and lost with two pair, Tens and Sixes



PokerStars Hand #132875556797: Tournament #1164585221, $20+$2 USD Hold'em No Limit - Level XII (150/300) - 2015/03/29 22:51:12 CET [2015/03/29 16:51:12 ET]
Table '1164585221 3130' 9-max Seat #2 is the button
Seat 1: ApollonK (11689 in chips) 
Seat 2: calibra1967 (25458 in chips) 
Seat 3: Czaaaar (14882 in chips) 
Seat 4: fmlx (7018 in chips) 
Seat 5: casiodk333 (25398 in chips) 
Seat 6: derek03r (19540 in chips) 
Seat 7: wvoron81 (22308 in chips) 
Seat 8: sherban80 (9257 in chips) 
ApollonK: posts the ante 40
calibra1967: posts the ante 40
Czaaaar: posts the ante 40
fmlx: posts the ante 40
casiodk333: posts the ante 40
derek03r: posts the ante 40
wvoron81: posts the ante 40
sherban80: posts the ante 40
Czaaaar: posts small blind 150
fmlx: posts big blind 300
*** HOLE CARDS ***
Dealt to casiodk333 [5c 9h]
casiodk333: folds 
derek03r: folds 
wvoron81: folds 
sherban80: folds 
ApollonK: folds 
calibra1967: calls 300
Czaaaar: folds 
fmlx: checks 
*** FLOP *** [Qd 6s Ks]
fmlx: checks 
calibra1967: checks 
*** TURN *** [Qd 6s Ks] [Qc]
fmlx: checks 
calibra1967: checks 
*** RIVER *** [Qd 6s Ks Qc] [5h]
fmlx: checks 
calibra1967: checks 
*** SHOW DOWN ***
fmlx: shows [Td Jh] (a pair of Queens)
calibra1967: shows [As 4d] (a pair of Queens - Ace kicker)
calibra1967 collected 1070 from pot
*** SUMMARY ***
Total pot 1070 | Rake 0 
Board [Qd 6s Ks Qc 5h]
Seat 1: ApollonK folded before Flop (didn't bet)
Seat 2: calibra1967 (button) showed [As 4d] and won (1070) with a pair of Queens
Seat 3: Czaaaar (small blind) folded before Flop
Seat 4: fmlx (big blind) showed [Td Jh] and lost with a pair of Queens
Seat 5: casiodk333 folded before Flop (didn't bet)
Seat 6: derek03r folded before Flop (didn't bet)
Seat 7: wvoron81 folded before Flop (didn't bet)
Seat 8: sherban80 folded before Flop (didn't bet)



PokerStars Hand #132875634305: Tournament #1164585221, $20+$2 USD Hold'em No Limit - Level XIII (200/400) - 2015/03/29 22:52:18 CET [2015/03/29 16:52:18 ET]
Table '1164585221 3130' 9-max Seat #3 is the button
Seat 1: ApollonK (11649 in chips) 
Seat 2: calibra1967 (26188 in chips) 
Seat 3: Czaaaar (14692 in chips) 
Seat 4: fmlx (6678 in chips) 
Seat 5: casiodk333 (25358 in chips) 
Seat 6: derek03r (19500 in chips) 
Seat 7: wvoron81 (22268 in chips) 
Seat 8: sherban80 (9217 in chips) 
Seat 9: said366 (10000 in chips) 
ApollonK: posts the ante 50
calibra1967: posts the ante 50
Czaaaar: posts the ante 50
fmlx: posts the ante 50
casiodk333: posts the ante 50
derek03r: posts the ante 50
wvoron81: posts the ante 50
sherban80: posts the ante 50
said366: posts the ante 50
fmlx: posts small blind 200
casiodk333: posts big blind 400
*** HOLE CARDS ***
Dealt to casiodk333 [Qh 6c]
derek03r: folds 
wvoron81: folds 
sherban80: folds 
said366: folds 
ApollonK: raises 488 to 888
calibra1967: calls 888
Czaaaar: folds 
fmlx: folds 
casiodk333: folds 
*** FLOP *** [6h Ac 8h]
ApollonK: bets 1400
calibra1967: calls 1400
*** TURN *** [6h Ac 8h] [4c]
ApollonK: checks 
calibra1967: checks 
*** RIVER *** [6h Ac 8h 4c] [6d]
ApollonK: checks 
calibra1967: checks 
*** SHOW DOWN ***
ApollonK: shows [Ts Qc] (a pair of Sixes)
calibra1967: shows [Tc Th] (two pair, Tens and Sixes)
calibra1967 collected 5626 from pot
*** SUMMARY ***
Total pot 5626 | Rake 0 
Board [6h Ac 8h 4c 6d]
Seat 1: ApollonK showed [Ts Qc] and lost with a pair of Sixes
Seat 2: calibra1967 showed [Tc Th] and won (5626) with two pair, Tens and Sixes
Seat 3: Czaaaar (button) folded before Flop (didn't bet)
Seat 4: fmlx (small blind) folded before Flop
Seat 5: casiodk333 (big blind) folded before Flop
Seat 6: derek03r folded before Flop (didn't bet)
Seat 7: wvoron81 folded before Flop (didn't bet)
Seat 8: sherban80 folded before Flop (didn't bet)
Seat 9: said366 folded before Flop (didn't bet)



PokerStars Hand #132875753723: Tournament #1164585221, $20+$2 USD Hold'em No Limit - Level XIII (200/400) - 2015/03/29 22:53:59 CET [2015/03/29 16:53:59 ET]
Table '1164585221 3130' 9-max Seat #4 is the button
Seat 1: ApollonK (9311 in chips) 
Seat 2: calibra1967 (29476 in chips) 
Seat 3: Czaaaar (14642 in chips) 
Seat 4: fmlx (6428 in chips) 
Seat 5: casiodk333 (24908 in chips) 
Seat 6: derek03r (19450 in chips) 
Seat 7: wvoron81 (22218 in chips) 
Seat 8: sherban80 (9167 in chips) 
Seat 9: said366 (9950 in chips) 
ApollonK: posts the ante 50
calibra1967: posts the ante 50
Czaaaar: posts the ante 50
fmlx: posts the ante 50
casiodk333: posts the ante 50
derek03r: posts the ante 50
wvoron81: posts the ante 50
sherban80: posts the ante 50
said366: posts the ante 50
casiodk333: posts small blind 200
derek03r: posts big blind 400
*** HOLE CARDS ***
Dealt to casiodk333 [9h Ac]
wvoron81: folds 
sherban80: folds 
said366: folds 
ApollonK: folds 
calibra1967: folds 
Czaaaar: raises 400 to 800
fmlx: folds 
casiodk333: folds 
derek03r: calls 400
*** FLOP *** [8c 6c Th]
derek03r: checks 
Czaaaar: checks 
*** TURN *** [8c 6c Th] [Kc]
derek03r: checks 
Czaaaar: bets 1125
derek03r: calls 1125
*** RIVER *** [8c 6c Th Kc] [5h]
derek03r: checks 
Czaaaar: checks 
*** SHOW DOWN ***
derek03r: shows [6s Kd] (two pair, Kings and Sixes)
Czaaaar: mucks hand 
derek03r collected 4500 from pot
*** SUMMARY ***
Total pot 4500 | Rake 0 
Board [8c 6c Th Kc 5h]
Seat 1: ApollonK folded before Flop (didn't bet)
Seat 2: calibra1967 folded before Flop (didn't bet)
Seat 3: Czaaaar mucked [Qs 9d]
Seat 4: fmlx (button) folded before Flop (didn't bet)
Seat 5: casiodk333 (small blind) folded before Flop
Seat 6: derek03r (big blind) showed [6s Kd] and won (4500) with two pair, Kings and Sixes
Seat 7: wvoron81 folded before Flop (didn't bet)
Seat 8: sherban80 folded before Flop (didn't bet)
Seat 9: said366 folded before Flop (didn't bet)



PokerStars Hand #132876571921: Tournament #1164585221, $20+$2 USD Hold'em No Limit - Level XIII (200/400) - 2015/03/29 23:07:43 CET [2015/03/29 17:07:43 ET]
Table '1164585221 3130' 9-max Seat #5 is the button
Seat 1: ApollonK (9261 in chips) 
Seat 2: calibra1967 (29426 in chips) 
Seat 3: Czaaaar (12667 in chips) 
Seat 4: Zug94 (10000 in chips) 
Seat 5: casiodk333 (24658 in chips) 
Seat 6: derek03r (21975 in chips) 
Seat 7: wvoron81 (22168 in chips) 
Seat 8: sherban80 (9117 in chips) 
Seat 9: said366 (9900 in chips) 
ApollonK: posts the ante 50
calibra1967: posts the ante 50
Czaaaar: posts the ante 50
Zug94: posts the ante 50
casiodk333: posts the ante 50
derek03r: posts the ante 50
wvoron81: posts the ante 50
sherban80: posts the ante 50
said366: posts the ante 50
derek03r: posts small blind 200
wvoron81: posts big blind 400
*** HOLE CARDS ***
Dealt to casiodk333 [2h 6s]
sherban80: folds 
said366: raises 400 to 800
ApollonK: folds 
calibra1967: folds 
Czaaaar: folds 
Zug94: folds 
casiodk333: folds 
derek03r: calls 600
wvoron81: folds 
*** FLOP *** [5d 6c 9h]
derek03r: checks 
said366: bets 888
derek03r: raises 888 to 1776
said366: raises 888 to 2664
derek03r: folds 
Uncalled bet (888) returned to said366
said366 collected 6002 from pot
said366: doesn't show hand 
*** SUMMARY ***
Total pot 6002 | Rake 0 
Board [5d 6c 9h]
Seat 1: ApollonK folded before Flop (didn't bet)
Seat 2: calibra1967 folded before Flop (didn't bet)
Seat 3: Czaaaar folded before Flop (didn't bet)
Seat 4: Zug94 folded before Flop (didn't bet)
Seat 5: casiodk333 (button) folded before Flop (didn't bet)
Seat 6: derek03r (small blind) folded on the Flop
Seat 7: wvoron81 (big blind) folded before Flop
Seat 8: sherban80 folded before Flop (didn't bet)
Seat 9: said366 collected (6002)



PokerStars Hand #132876660789: Tournament #1164585221, $20+$2 USD Hold'em No Limit - Level XIII (200/400) - 2015/03/29 23:08:57 CET [2015/03/29 17:08:57 ET]
Table '1164585221 3130' 9-max Seat #6 is the button
Seat 1: ApollonK (9211 in chips) 
Seat 2: calibra1967 (29376 in chips) 
Seat 3: Czaaaar (12617 in chips) 
Seat 4: Zug94 (9950 in chips) 
Seat 5: casiodk333 (24608 in chips) 
Seat 6: derek03r (19349 in chips) 
Seat 7: wvoron81 (21718 in chips) 
Seat 8: sherban80 (9067 in chips) 
Seat 9: said366 (13276 in chips) 
ApollonK: posts the ante 50
calibra1967: posts the ante 50
Czaaaar: posts the ante 50
Zug94: posts the ante 50
casiodk333: posts the ante 50
derek03r: posts the ante 50
wvoron81: posts the ante 50
sherban80: posts the ante 50
said366: posts the ante 50
wvoron81: posts small blind 200
sherban80: posts big blind 400
*** HOLE CARDS ***
Dealt to casiodk333 [6c 8d]
said366: folds 
ApollonK: folds 
calibra1967: folds 
Czaaaar: folds 
Zug94: folds 
casiodk333: folds 
derek03r: folds 
wvoron81: folds 
Uncalled bet (200) returned to sherban80
sherban80 collected 850 from pot
sherban80: doesn't show hand 
*** SUMMARY ***
Total pot 850 | Rake 0 
Seat 1: ApollonK folded before Flop (didn't bet)
Seat 2: calibra1967 folded before Flop (didn't bet)
Seat 3: Czaaaar folded before Flop (didn't bet)
Seat 4: Zug94 folded before Flop (didn't bet)
Seat 5: casiodk333 folded before Flop (didn't bet)
Seat 6: derek03r (button) folded before Flop (didn't bet)
Seat 7: wvoron81 (small blind) folded before Flop
Seat 8: sherban80 (big blind) collected (850)
Seat 9: said366 folded before Flop (didn't bet)



PokerStars Hand #132876716593: Tournament #1164585221, $20+$2 USD Hold'em No Limit - Level XIII (200/400) - 2015/03/29 23:09:43 CET [2015/03/29 17:09:43 ET]
Table '1164585221 3130' 9-max Seat #7 is the button
Seat 1: ApollonK (9161 in chips) 
Seat 2: calibra1967 (29326 in chips) 
Seat 3: Czaaaar (12567 in chips) 
Seat 4: Zug94 (9900 in chips) 
Seat 5: casiodk333 (24558 in chips) 
Seat 6: derek03r (19299 in chips) 
Seat 7: wvoron81 (21468 in chips) 
Seat 8: sherban80 (9667 in chips) 
Seat 9: said366 (13226 in chips) 
ApollonK: posts the ante 50
calibra1967: posts the ante 50
Czaaaar: posts the ante 50
Zug94: posts the ante 50
casiodk333: posts the ante 50
derek03r: posts the ante 50
wvoron81: posts the ante 50
sherban80: posts the ante 50
said366: posts the ante 50
sherban80: posts small blind 200
said366: posts big blind 400
*** HOLE CARDS ***
Dealt to casiodk333 [Qh 9c]
ApollonK: folds 
calibra1967: folds 
Czaaaar: folds 
Zug94: raises 400 to 800
casiodk333: folds 
derek03r: folds 
wvoron81: folds 
sherban80: folds 
said366: calls 400
*** FLOP *** [Kh 4c 4s]
said366: checks 
Zug94: bets 900
said366: folds 
Uncalled bet (900) returned to Zug94
Zug94 collected 2250 from pot
*** SUMMARY ***
Total pot 2250 | Rake 0 
Board [Kh 4c 4s]
Seat 1: ApollonK folded before Flop (didn't bet)
Seat 2: calibra1967 folded before Flop (didn't bet)
Seat 3: Czaaaar folded before Flop (didn't bet)
Seat 4: Zug94 collected (2250)
Seat 5: casiodk333 folded before Flop (didn't bet)
Seat 6: derek03r folded before Flop (didn't bet)
Seat 7: wvoron81 (button) folded before Flop (didn't bet)
Seat 8: sherban80 (small blind) folded before Flop
Seat 9: said366 (big blind) folded on the Flop



PokerStars Hand #132876793136: Tournament #1164585221, $20+$2 USD Hold'em No Limit - Level XIII (200/400) - 2015/03/29 23:10:48 CET [2015/03/29 17:10:48 ET]
Table '1164585221 3130' 9-max Seat #8 is the button
Seat 1: ApollonK (9111 in chips) 
Seat 2: calibra1967 (29276 in chips) 
Seat 3: Czaaaar (12517 in chips) 
Seat 4: Zug94 (11300 in chips) 
Seat 5: casiodk333 (24508 in chips) 
Seat 6: derek03r (19249 in chips) 
Seat 7: wvoron81 (21418 in chips) 
Seat 8: sherban80 (9417 in chips) 
Seat 9: said366 (12376 in chips) 
ApollonK: posts the ante 50
calibra1967: posts the ante 50
Czaaaar: posts the ante 50
Zug94: posts the ante 50
casiodk333: posts the ante 50
derek03r: posts the ante 50
wvoron81: posts the ante 50
sherban80: posts the ante 50
said366: posts the ante 50
said366: posts small blind 200
ApollonK: posts big blind 400
*** HOLE CARDS ***
Dealt to casiodk333 [As 9s]
calibra1967: folds 
Czaaaar: folds 
Zug94: folds 
casiodk333: raises 488 to 888
derek03r: folds 
wvoron81: folds 
sherban80: folds 
said366: folds 
ApollonK: folds 
Uncalled bet (488) returned to casiodk333
casiodk333 collected 1450 from pot
*** SUMMARY ***
Total pot 1450 | Rake 0 
Seat 1: ApollonK (big blind) folded before Flop
Seat 2: calibra1967 folded before Flop (didn't bet)
Seat 3: Czaaaar folded before Flop (didn't bet)
Seat 4: Zug94 folded before Flop (didn't bet)
Seat 5: casiodk333 collected (1450)
Seat 6: derek03r folded before Flop (didn't bet)
Seat 7: wvoron81 folded before Flop (didn't bet)
Seat 8: sherban80 (button) folded before Flop (didn't bet)
Seat 9: said366 (small blind) folded before Flop



PokerStars Hand #132876881992: Tournament #1164585221, $20+$2 USD Hold'em No Limit - Level XIII (200/400) - 2015/03/29 23:12:03 CET [2015/03/29 17:12:03 ET]
Table '1164585221 3130' 9-max Seat #9 is the button
Seat 1: ApollonK (8661 in chips) 
Seat 2: calibra1967 (29226 in chips) 
Seat 3: Czaaaar (12467 in chips) 
Seat 4: Zug94 (11250 in chips) 
Seat 5: casiodk333 (25508 in chips) 
Seat 6: derek03r (19199 in chips) 
Seat 7: wvoron81 (21368 in chips) 
Seat 8: sherban80 (9367 in chips) 
Seat 9: said366 (12126 in chips) 
ApollonK: posts the ante 50
calibra1967: posts the ante 50
Czaaaar: posts the ante 50
Zug94: posts the ante 50
casiodk333: posts the ante 50
derek03r: posts the ante 50
wvoron81: posts the ante 50
sherban80: posts the ante 50
said366: posts the ante 50
ApollonK: posts small blind 200
calibra1967: posts big blind 400
*** HOLE CARDS ***
Dealt to casiodk333 [Ah 8c]
Czaaaar: folds 
Zug94: folds 
casiodk333: folds 
derek03r: raises 400 to 800
wvoron81: folds 
sherban80: folds 
said366: calls 800
ApollonK: folds 
calibra1967: folds 
*** FLOP *** [9c Td 8d]
derek03r: bets 800
said366: calls 800
*** TURN *** [9c Td 8d] [Jd]
derek03r: checks 
said366: checks 
*** RIVER *** [9c Td 8d Jd] [4h]
derek03r: checks 
said366: bets 2777
derek03r: folds 
Uncalled bet (2777) returned to said366
said366 collected 4250 from pot
said366: doesn't show hand 
*** SUMMARY ***
Total pot 4250 | Rake 0 
Board [9c Td 8d Jd 4h]
Seat 1: ApollonK (small blind) folded before Flop
Seat 2: calibra1967 (big blind) folded before Flop
Seat 3: Czaaaar folded before Flop (didn't bet)
Seat 4: Zug94 folded before Flop (didn't bet)
Seat 5: casiodk333 folded before Flop (didn't bet)
Seat 6: derek03r folded on the River
Seat 7: wvoron81 folded before Flop (didn't bet)
Seat 8: sherban80 folded before Flop (didn't bet)
Seat 9: said366 (button) collected (4250)



PokerStars Hand #132876986418: Tournament #1164585221, $20+$2 USD Hold'em No Limit - Level XIII (200/400) - 2015/03/29 23:13:32 CET [2015/03/29 17:13:32 ET]
Table '1164585221 3130' 9-max Seat #1 is the button
Seat 1: ApollonK (8411 in chips) 
Seat 2: calibra1967 (28776 in chips) 
Seat 3: Czaaaar (12417 in chips) 
Seat 4: Zug94 (11200 in chips) 
Seat 5: casiodk333 (25458 in chips) 
Seat 6: derek03r (17549 in chips) 
Seat 7: wvoron81 (21318 in chips) 
Seat 8: sherban80 (9317 in chips) 
Seat 9: said366 (14726 in chips) 
ApollonK: posts the ante 50
calibra1967: posts the ante 50
Czaaaar: posts the ante 50
Zug94: posts the ante 50
casiodk333: posts the ante 50
derek03r: posts the ante 50
wvoron81: posts the ante 50
sherban80: posts the ante 50
said366: posts the ante 50
calibra1967: posts small blind 200
Czaaaar: posts big blind 400
*** HOLE CARDS ***
Dealt to casiodk333 [Th 5c]
Zug94: folds 
casiodk333: folds 
derek03r: raises 400 to 800
wvoron81: folds 
sherban80: folds 
said366: calls 800
ApollonK: calls 800
calibra1967: folds 
Czaaaar: folds 
*** FLOP *** [9s 7c 4d]
derek03r: bets 1145
said366: folds 
ApollonK: raises 6416 to 7561 and is all-in
derek03r: calls 6416
*** TURN *** [9s 7c 4d] [5d]
*** RIVER *** [9s 7c 4d 5d] [7h]
*** SHOW DOWN ***
derek03r: shows [Kd Ad] (a pair of Sevens)
ApollonK: shows [9c Kc] (two pair, Nines and Sevens)
ApollonK collected 18572 from pot
*** SUMMARY ***
Total pot 18572 | Rake 0 
Board [9s 7c 4d 5d 7h]
Seat 1: ApollonK (button) showed [9c Kc] and won (18572) with two pair, Nines and Sevens
Seat 2: calibra1967 (small blind) folded before Flop
Seat 3: Czaaaar (big blind) folded before Flop
Seat 4: Zug94 folded before Flop (didn't bet)
Seat 5: casiodk333 folded before Flop (didn't bet)
Seat 6: derek03r showed [Kd Ad] and lost with a pair of Sevens
Seat 7: wvoron81 folded before Flop (didn't bet)
Seat 8: sherban80 folded before Flop (didn't bet)
Seat 9: said366 folded on the Flop



PokerStars Hand #132877094129: Tournament #1164585221, $20+$2 USD Hold'em No Limit - Level XIV (250/500) - 2015/03/29 23:15:04 CET [2015/03/29 17:15:04 ET]
Table '1164585221 3130' 9-max Seat #2 is the button
Seat 1: ApollonK (18572 in chips) 
Seat 2: calibra1967 (28526 in chips) 
Seat 3: Czaaaar (11967 in chips) 
Seat 4: Zug94 (11150 in chips) 
Seat 5: casiodk333 (25408 in chips) 
Seat 6: derek03r (9138 in chips) 
Seat 7: wvoron81 (21268 in chips) 
Seat 8: sherban80 (9267 in chips) 
Seat 9: said366 (13876 in chips) 
ApollonK: posts the ante 60
calibra1967: posts the ante 60
Czaaaar: posts the ante 60
Zug94: posts the ante 60
casiodk333: posts the ante 60
derek03r: posts the ante 60
wvoron81: posts the ante 60
sherban80: posts the ante 60
said366: posts the ante 60
Czaaaar: posts small blind 250
Zug94: posts big blind 500
*** HOLE CARDS ***
Dealt to casiodk333 [6s 6c]
casiodk333: raises 500 to 1000
derek03r: folds 
wvoron81: folds 
sherban80: folds 
said366: folds 
ApollonK: folds 
calibra1967: folds 
Czaaaar: folds 
Zug94: folds 
Uncalled bet (500) returned to casiodk333
casiodk333 collected 1790 from pot
*** SUMMARY ***
Total pot 1790 | Rake 0 
Seat 1: ApollonK folded before Flop (didn't bet)
Seat 2: calibra1967 (button) folded before Flop (didn't bet)
Seat 3: Czaaaar (small blind) folded before Flop
Seat 4: Zug94 (big blind) folded before Flop
Seat 5: casiodk333 collected (1790)
Seat 6: derek03r folded before Flop (didn't bet)
Seat 7: wvoron81 folded before Flop (didn't bet)
Seat 8: sherban80 folded before Flop (didn't bet)
Seat 9: said366 folded before Flop (didn't bet)



PokerStars Hand #132877139827: Tournament #1164585221, $20+$2 USD Hold'em No Limit - Level XIV (250/500) - 2015/03/29 23:15:45 CET [2015/03/29 17:15:45 ET]
Table '1164585221 3130' 9-max Seat #3 is the button
Seat 1: ApollonK (18512 in chips) 
Seat 2: calibra1967 (28466 in chips) 
Seat 3: Czaaaar (11657 in chips) 
Seat 4: Zug94 (10590 in chips) 
Seat 5: casiodk333 (26638 in chips) 
Seat 6: derek03r (9078 in chips) 
Seat 7: wvoron81 (21208 in chips) 
Seat 8: sherban80 (9207 in chips) 
Seat 9: said366 (13816 in chips) 
ApollonK: posts the ante 60
calibra1967: posts the ante 60
Czaaaar: posts the ante 60
Zug94: posts the ante 60
casiodk333: posts the ante 60
derek03r: posts the ante 60
wvoron81: posts the ante 60
sherban80: posts the ante 60
said366: posts the ante 60
Zug94: posts small blind 250
casiodk333: posts big blind 500
*** HOLE CARDS ***
Dealt to casiodk333 [Qs 2c]
derek03r: folds 
wvoron81: folds 
sherban80: raises 647 to 1147
said366: folds 
ApollonK: folds 
calibra1967: folds 
Czaaaar: folds 
Zug94: folds 
casiodk333: folds 
Uncalled bet (647) returned to sherban80
sherban80 collected 1790 from pot
*** SUMMARY ***
Total pot 1790 | Rake 0 
Seat 1: ApollonK folded before Flop (didn't bet)
Seat 2: calibra1967 folded before Flop (didn't bet)
Seat 3: Czaaaar (button) folded before Flop (didn't bet)
Seat 4: Zug94 (small blind) folded before Flop
Seat 5: casiodk333 (big blind) folded before Flop
Seat 6: derek03r folded before Flop (didn't bet)
Seat 7: wvoron81 folded before Flop (didn't bet)
Seat 8: sherban80 collected (1790)
Seat 9: said366 folded before Flop (didn't bet)



PokerStars Hand #132877195120: Tournament #1164585221, $20+$2 USD Hold'em No Limit - Level XIV (250/500) - 2015/03/29 23:16:30 CET [2015/03/29 17:16:30 ET]
Table '1164585221 3130' 9-max Seat #4 is the button
Seat 1: ApollonK (18452 in chips) 
Seat 2: calibra1967 (28406 in chips) 
Seat 3: Czaaaar (11597 in chips) 
Seat 4: Zug94 (10280 in chips) 
Seat 5: casiodk333 (26078 in chips) 
Seat 6: derek03r (9018 in chips) 
Seat 7: wvoron81 (21148 in chips) 
Seat 8: sherban80 (10437 in chips) 
Seat 9: said366 (13756 in chips) 
ApollonK: posts the ante 60
calibra1967: posts the ante 60
Czaaaar: posts the ante 60
Zug94: posts the ante 60
casiodk333: posts the ante 60
derek03r: posts the ante 60
wvoron81: posts the ante 60
sherban80: posts the ante 60
said366: posts the ante 60
casiodk333: posts small blind 250
derek03r: posts big blind 500
*** HOLE CARDS ***
Dealt to casiodk333 [Kd 5c]
wvoron81: folds 
sherban80: folds 
said366: folds 
ApollonK: folds 
calibra1967: folds 
Czaaaar: folds 
Zug94: folds 
casiodk333: calls 250
derek03r: raises 1000 to 1500
casiodk333: calls 1000
*** FLOP *** [Jh 2h Td]
casiodk333: checks 
derek03r: bets 2000
casiodk333: folds 
Uncalled bet (2000) returned to derek03r
derek03r collected 3540 from pot
derek03r: doesn't show hand 
*** SUMMARY ***
Total pot 3540 | Rake 0 
Board [Jh 2h Td]
Seat 1: ApollonK folded before Flop (didn't bet)
Seat 2: calibra1967 folded before Flop (didn't bet)
Seat 3: Czaaaar folded before Flop (didn't bet)
Seat 4: Zug94 (button) folded before Flop (didn't bet)
Seat 5: casiodk333 (small blind) folded on the Flop
Seat 6: derek03r (big blind) collected (3540)
Seat 7: wvoron81 folded before Flop (didn't bet)
Seat 8: sherban80 folded before Flop (didn't bet)
Seat 9: said366 folded before Flop (didn't bet)



PokerStars Hand #132877266362: Tournament #1164585221, $20+$2 USD Hold'em No Limit - Level XIV (250/500) - 2015/03/29 23:17:28 CET [2015/03/29 17:17:28 ET]
Table '1164585221 3130' 9-max Seat #5 is the button
Seat 1: ApollonK (18392 in chips) 
Seat 2: calibra1967 (28346 in chips) 
Seat 3: Czaaaar (11537 in chips) 
Seat 4: Zug94 (10220 in chips) 
Seat 5: casiodk333 (24518 in chips) 
Seat 6: derek03r (10998 in chips) 
Seat 7: wvoron81 (21088 in chips) 
Seat 8: sherban80 (10377 in chips) 
Seat 9: said366 (13696 in chips) 
ApollonK: posts the ante 60
calibra1967: posts the ante 60
Czaaaar: posts the ante 60
Zug94: posts the ante 60
casiodk333: posts the ante 60
derek03r: posts the ante 60
wvoron81: posts the ante 60
sherban80: posts the ante 60
said366: posts the ante 60
derek03r: posts small blind 250
wvoron81: posts big blind 500
*** HOLE CARDS ***
Dealt to casiodk333 [Tc 8h]
sherban80: folds 
said366: raises 500 to 1000
ApollonK: folds 
calibra1967: raises 1000 to 2000
Czaaaar: folds 
Zug94: folds 
casiodk333: folds 
derek03r: folds 
wvoron81: folds 
said366: calls 1000
*** FLOP *** [Ks Kh Qd]
said366: checks 
calibra1967: bets 2000
said366: folds 
Uncalled bet (2000) returned to calibra1967
calibra1967 collected 5290 from pot
calibra1967: shows [Qh Qs]
*** SUMMARY ***
Total pot 5290 | Rake 0 
Board [Ks Kh Qd]
Seat 1: ApollonK folded before Flop (didn't bet)
Seat 2: calibra1967 collected (5290)
Seat 3: Czaaaar folded before Flop (didn't bet)
Seat 4: Zug94 folded before Flop (didn't bet)
Seat 5: casiodk333 (button) folded before Flop (didn't bet)
Seat 6: derek03r (small blind) folded before Flop
Seat 7: wvoron81 (big blind) folded before Flop
Seat 8: sherban80 folded before Flop (didn't bet)
Seat 9: said366 folded on the Flop



PokerStars Hand #132877326342: Tournament #1164585221, $20+$2 USD Hold'em No Limit - Level XIV (250/500) - 2015/03/29 23:18:18 CET [2015/03/29 17:18:18 ET]
Table '1164585221 3130' 9-max Seat #6 is the button
Seat 1: ApollonK (18332 in chips) 
Seat 2: calibra1967 (31576 in chips) 
Seat 3: Czaaaar (11477 in chips) 
Seat 4: Zug94 (10160 in chips) 
Seat 5: casiodk333 (24458 in chips) 
Seat 6: derek03r (10688 in chips) 
Seat 7: wvoron81 (20528 in chips) 
Seat 8: sherban80 (10317 in chips) 
Seat 9: said366 (11636 in chips) 
ApollonK: posts the ante 60
calibra1967: posts the ante 60
Czaaaar: posts the ante 60
Zug94: posts the ante 60
casiodk333: posts the ante 60
derek03r: posts the ante 60
wvoron81: posts the ante 60
sherban80: posts the ante 60
said366: posts the ante 60
wvoron81: posts small blind 250
sherban80: posts big blind 500
*** HOLE CARDS ***
Dealt to casiodk333 [7c Jc]
said366: folds 
ApollonK: raises 750 to 1250
calibra1967: folds 
said366 said, "Wat had je"
Czaaaar: folds 
Zug94: calls 1250
calibra1967 said, "QQ"
casiodk333: calls 1250
derek03r: raises 9378 to 10628 and is all-in
wvoron81: folds 
sherban80: folds 
ApollonK: raises 7644 to 18272 and is all-in
Zug94: folds 
casiodk333: folds 
Uncalled bet (7644) returned to ApollonK
*** FLOP *** [6d Ad 8h]
*** TURN *** [6d Ad 8h] [2d]
*** RIVER *** [6d Ad 8h 2d] [4s]
*** SHOW DOWN ***
ApollonK: shows [Ac Kd] (a pair of Aces)
derek03r: shows [9h 9c] (a pair of Nines)
ApollonK collected 25046 from pot
derek03r finished the tournament in 32567th place
*** SUMMARY ***
Total pot 25046 | Rake 0 
Board [6d Ad 8h 2d 4s]
Seat 1: ApollonK showed [Ac Kd] and won (25046) with a pair of Aces
Seat 2: calibra1967 folded before Flop (didn't bet)
Seat 3: Czaaaar folded before Flop (didn't bet)
Seat 4: Zug94 folded before Flop
Seat 5: casiodk333 folded before Flop
Seat 6: derek03r (button) showed [9h 9c] and lost with a pair of Nines
Seat 7: wvoron81 (small blind) folded before Flop
Seat 8: sherban80 (big blind) folded before Flop
Seat 9: said366 folded before Flop (didn't bet)



PokerStars Hand #132877433184: Tournament #1164585221, $20+$2 USD Hold'em No Limit - Level XIV (250/500) - 2015/03/29 23:19:47 CET [2015/03/29 17:19:47 ET]
Table '1164585221 3130' 9-max Seat #7 is the button
Seat 1: ApollonK (32690 in chips) 
Seat 2: calibra1967 (31516 in chips) 
Seat 3: Czaaaar (11417 in chips) 
Seat 4: Zug94 (8850 in chips) 
Seat 5: casiodk333 (23148 in chips) 
Seat 7: wvoron81 (20218 in chips) 
Seat 8: sherban80 (9757 in chips) 
Seat 9: said366 (11576 in chips) 
ApollonK: posts the ante 60
calibra1967: posts the ante 60
Czaaaar: posts the ante 60
Zug94: posts the ante 60
casiodk333: posts the ante 60
wvoron81: posts the ante 60
sherban80: posts the ante 60
said366: posts the ante 60
sherban80: posts small blind 250
said366: posts big blind 500
*** HOLE CARDS ***
Dealt to casiodk333 [Kc Jh]
ApollonK: folds 
calibra1967: calls 500
Czaaaar: folds 
Zug94: folds 
casiodk333: raises 500 to 1000
wvoron81: folds 
sherban80: folds 
said366: calls 500
calibra1967: calls 500
*** FLOP *** [3d 8c 6s]
said366: checks 
calibra1967: checks 
casiodk333: bets 2086
said366: folds 
calibra1967: folds 
Uncalled bet (2086) returned to casiodk333
casiodk333 collected 3730 from pot
*** SUMMARY ***
Total pot 3730 | Rake 0 
Board [3d 8c 6s]
Seat 1: ApollonK folded before Flop (didn't bet)
Seat 2: calibra1967 folded on the Flop
Seat 3: Czaaaar folded before Flop (didn't bet)
Seat 4: Zug94 folded before Flop (didn't bet)
Seat 5: casiodk333 collected (3730)
Seat 7: wvoron81 (button) folded before Flop (didn't bet)
Seat 8: sherban80 (small blind) folded before Flop
Seat 9: said366 (big blind) folded on the Flop



PokerStars Hand #132877522289: Tournament #1164585221, $20+$2 USD Hold'em No Limit - Level XIV (250/500) - 2015/03/29 23:21:02 CET [2015/03/29 17:21:02 ET]
Table '1164585221 3130' 9-max Seat #8 is the button
Seat 1: ApollonK (32630 in chips) 
Seat 2: calibra1967 (30456 in chips) 
Seat 3: Czaaaar (11357 in chips) 
Seat 4: Zug94 (8790 in chips) 
Seat 5: casiodk333 (25818 in chips) 
Seat 6: 3roleibus (6767 in chips) 
Seat 7: wvoron81 (20158 in chips) 
Seat 8: sherban80 (9447 in chips) 
Seat 9: said366 (10516 in chips) 
ApollonK: posts the ante 60
calibra1967: posts the ante 60
Czaaaar: posts the ante 60
Zug94: posts the ante 60
casiodk333: posts the ante 60
3roleibus: posts the ante 60
wvoron81: posts the ante 60
sherban80: posts the ante 60
said366: posts the ante 60
said366: posts small blind 250
ApollonK: posts big blind 500
*** HOLE CARDS ***
Dealt to casiodk333 [Jc 2s]
calibra1967: raises 500 to 1000
Czaaaar: folds 
Zug94: folds 
casiodk333: folds 
3roleibus: folds 
wvoron81: folds 
sherban80: calls 1000
said366: folds 
ApollonK: calls 500
*** FLOP *** [8s 9h Kh]
ApollonK: checks 
calibra1967: checks 
sherban80: checks 
*** TURN *** [8s 9h Kh] [7s]
ApollonK: checks 
calibra1967: bets 1000
sherban80: calls 1000
ApollonK: folds 
*** RIVER *** [8s 9h Kh 7s] [Js]
calibra1967: checks 
sherban80: checks 
*** SHOW DOWN ***
calibra1967: shows [Ac 6c] (high card Ace)
sherban80: shows [8d Ad] (a pair of Eights)
sherban80 collected 5790 from pot
*** SUMMARY ***
Total pot 5790 | Rake 0 
Board [8s 9h Kh 7s Js]
Seat 1: ApollonK (big blind) folded on the Turn
Seat 2: calibra1967 showed [Ac 6c] and lost with high card Ace
Seat 3: Czaaaar folded before Flop (didn't bet)
Seat 4: Zug94 folded before Flop (didn't bet)
Seat 5: casiodk333 folded before Flop (didn't bet)
Seat 6: 3roleibus folded before Flop (didn't bet)
Seat 7: wvoron81 folded before Flop (didn't bet)
Seat 8: sherban80 (button) showed [8d Ad] and won (5790) with a pair of Eights
Seat 9: said366 (small blind) folded before Flop



PokerStars Hand #132877639377: Tournament #1164585221, $20+$2 USD Hold'em No Limit - Level XIV (250/500) - 2015/03/29 23:22:41 CET [2015/03/29 17:22:41 ET]
Table '1164585221 3130' 9-max Seat #9 is the button
Seat 1: ApollonK (31570 in chips) 
Seat 2: calibra1967 (28396 in chips) 
Seat 3: Czaaaar (11297 in chips) 
Seat 4: Zug94 (8730 in chips) 
Seat 5: casiodk333 (25758 in chips) 
Seat 6: 3roleibus (6707 in chips) 
Seat 7: wvoron81 (20098 in chips) 
Seat 8: sherban80 (13177 in chips) 
Seat 9: said366 (10206 in chips) 
ApollonK: posts the ante 60
calibra1967: posts the ante 60
Czaaaar: posts the ante 60
Zug94: posts the ante 60
casiodk333: posts the ante 60
3roleibus: posts the ante 60
wvoron81: posts the ante 60
sherban80: posts the ante 60
said366: posts the ante 60
ApollonK: posts small blind 250
calibra1967: posts big blind 500
*** HOLE CARDS ***
Dealt to casiodk333 [8s 7d]
Czaaaar: folds 
Zug94: folds 
said366 said, "jammer"
casiodk333: folds 
3roleibus: folds 
wvoron81: raises 750 to 1250
sherban80: folds 
said366: folds 
ApollonK: folds 
calibra1967: folds 
Uncalled bet (750) returned to wvoron81
wvoron81 collected 1790 from pot
wvoron81: doesn't show hand 
*** SUMMARY ***
Total pot 1790 | Rake 0 
Seat 1: ApollonK (small blind) folded before Flop
Seat 2: calibra1967 (big blind) folded before Flop
Seat 3: Czaaaar folded before Flop (didn't bet)
Seat 4: Zug94 folded before Flop (didn't bet)
Seat 5: casiodk333 folded before Flop (didn't bet)
Seat 6: 3roleibus folded before Flop (didn't bet)
Seat 7: wvoron81 collected (1790)
Seat 8: sherban80 folded before Flop (didn't bet)
Seat 9: said366 (button) folded before Flop (didn't bet)



PokerStars Hand #132877676306: Tournament #1164585221, $20+$2 USD Hold'em No Limit - Level XIV (250/500) - 2015/03/29 23:23:13 CET [2015/03/29 17:23:13 ET]
Table '1164585221 3130' 9-max Seat #1 is the button
Seat 1: ApollonK (31260 in chips) 
Seat 2: calibra1967 (27836 in chips) 
Seat 3: Czaaaar (11237 in chips) 
Seat 4: Zug94 (8670 in chips) 
Seat 5: casiodk333 (25698 in chips) 
Seat 6: 3roleibus (6647 in chips) 
Seat 7: wvoron81 (21328 in chips) 
Seat 8: sherban80 (13117 in chips) 
Seat 9: said366 (10146 in chips) 
ApollonK: posts the ante 60
calibra1967: posts the ante 60
Czaaaar: posts the ante 60
Zug94: posts the ante 60
casiodk333: posts the ante 60
3roleibus: posts the ante 60
wvoron81: posts the ante 60
sherban80: posts the ante 60
said366: posts the ante 60
calibra1967: posts small blind 250
Czaaaar: posts big blind 500
*** HOLE CARDS ***
Dealt to casiodk333 [7s 6d]
Zug94: folds 
casiodk333: folds 
3roleibus: raises 500 to 1000
wvoron81: folds 
sherban80: folds 
said366: folds 
ApollonK: folds 
calibra1967: folds 
Czaaaar: folds 
Uncalled bet (500) returned to 3roleibus
3roleibus collected 1790 from pot
*** SUMMARY ***
Total pot 1790 | Rake 0 
Seat 1: ApollonK (button) folded before Flop (didn't bet)
Seat 2: calibra1967 (small blind) folded before Flop
Seat 3: Czaaaar (big blind) folded before Flop
Seat 4: Zug94 folded before Flop (didn't bet)
Seat 5: casiodk333 folded before Flop (didn't bet)
Seat 6: 3roleibus collected (1790)
Seat 7: wvoron81 folded before Flop (didn't bet)
Seat 8: sherban80 folded before Flop (didn't bet)
Seat 9: said366 folded before Flop (didn't bet)



PokerStars Hand #132877708789: Tournament #1164585221, $20+$2 USD Hold'em No Limit - Level XIV (250/500) - 2015/03/29 23:23:41 CET [2015/03/29 17:23:41 ET]
Table '1164585221 3130' 9-max Seat #2 is the button
Seat 1: ApollonK (31200 in chips) 
Seat 2: calibra1967 (27526 in chips) 
Seat 3: Czaaaar (10677 in chips) 
Seat 4: Zug94 (8610 in chips) 
Seat 5: casiodk333 (25638 in chips) 
Seat 6: 3roleibus (7877 in chips) 
Seat 7: wvoron81 (21268 in chips) 
Seat 8: sherban80 (13057 in chips) 
Seat 9: said366 (10086 in chips) 
ApollonK: posts the ante 60
calibra1967: posts the ante 60
Czaaaar: posts the ante 60
Zug94: posts the ante 60
casiodk333: posts the ante 60
3roleibus: posts the ante 60
wvoron81: posts the ante 60
sherban80: posts the ante 60
said366: posts the ante 60
Czaaaar: posts small blind 250
Zug94: posts big blind 500
*** HOLE CARDS ***
Dealt to casiodk333 [7c 3s]
casiodk333: folds 
3roleibus: folds 
wvoron81: folds 
sherban80: raises 500 to 1000
said366: folds 
ApollonK: folds 
calibra1967: folds 
Czaaaar: folds 
Zug94: raises 7550 to 8550 and is all-in
sherban80: folds 
Uncalled bet (7550) returned to Zug94
Zug94 collected 2790 from pot
*** SUMMARY ***
Total pot 2790 | Rake 0 
Seat 1: ApollonK folded before Flop (didn't bet)
Seat 2: calibra1967 (button) folded before Flop (didn't bet)
Seat 3: Czaaaar (small blind) folded before Flop
Seat 4: Zug94 (big blind) collected (2790)
Seat 5: casiodk333 folded before Flop (didn't bet)
Seat 6: 3roleibus folded before Flop (didn't bet)
Seat 7: wvoron81 folded before Flop (didn't bet)
Seat 8: sherban80 folded before Flop
Seat 9: said366 folded before Flop (didn't bet)



PokerStars Hand #132877780731: Tournament #1164585221, $20+$2 USD Hold'em No Limit - Level XV (300/600) - 2015/03/29 23:24:42 CET [2015/03/29 17:24:42 ET]
Table '1164585221 3130' 9-max Seat #3 is the button
Seat 1: ApollonK (31140 in chips) 
Seat 2: calibra1967 (27466 in chips) 
Seat 3: Czaaaar (10367 in chips) 
Seat 4: Zug94 (10340 in chips) 
Seat 5: casiodk333 (25578 in chips) 
Seat 6: 3roleibus (7817 in chips) 
Seat 7: wvoron81 (21208 in chips) 
Seat 8: sherban80 (11997 in chips) 
Seat 9: said366 (10026 in chips) 
ApollonK: posts the ante 70
calibra1967: posts the ante 70
Czaaaar: posts the ante 70
Zug94: posts the ante 70
casiodk333: posts the ante 70
3roleibus: posts the ante 70
wvoron81: posts the ante 70
sherban80: posts the ante 70
said366: posts the ante 70
Zug94: posts small blind 300
casiodk333: posts big blind 600
*** HOLE CARDS ***
Dealt to casiodk333 [4s 7h]
3roleibus: folds 
wvoron81: folds 
sherban80: folds 
said366: folds 
ApollonK: folds 
calibra1967: raises 600 to 1200
Czaaaar: folds 
Zug94: folds 
casiodk333: calls 600
*** FLOP *** [Td 2h 8c]
casiodk333: bets 900
calibra1967: raises 2100 to 3000
casiodk333: folds 
Uncalled bet (2100) returned to calibra1967
calibra1967 collected 5130 from pot
*** SUMMARY ***
Total pot 5130 | Rake 0 
Board [Td 2h 8c]
Seat 1: ApollonK folded before Flop (didn't bet)
Seat 2: calibra1967 collected (5130)
Seat 3: Czaaaar (button) folded before Flop (didn't bet)
Seat 4: Zug94 (small blind) folded before Flop
Seat 5: casiodk333 (big blind) folded on the Flop
Seat 6: 3roleibus folded before Flop (didn't bet)
Seat 7: wvoron81 folded before Flop (didn't bet)
Seat 8: sherban80 folded before Flop (didn't bet)
Seat 9: said366 folded before Flop (didn't bet)



PokerStars Hand #132877852491: Tournament #1164585221, $20+$2 USD Hold'em No Limit - Level XV (300/600) - 2015/03/29 23:25:44 CET [2015/03/29 17:25:44 ET]
Table '1164585221 3130' 9-max Seat #4 is the button
Seat 1: ApollonK (31070 in chips) 
Seat 2: calibra1967 (30426 in chips) 
Seat 3: Czaaaar (10297 in chips) 
Seat 4: Zug94 (9970 in chips) 
Seat 5: casiodk333 (23408 in chips) 
Seat 6: 3roleibus (7747 in chips) 
Seat 7: wvoron81 (21138 in chips) 
Seat 8: sherban80 (11927 in chips) 
Seat 9: said366 (9956 in chips) 
ApollonK: posts the ante 70
calibra1967: posts the ante 70
Czaaaar: posts the ante 70
Zug94: posts the ante 70
casiodk333: posts the ante 70
3roleibus: posts the ante 70
wvoron81: posts the ante 70
sherban80: posts the ante 70
said366: posts the ante 70
casiodk333: posts small blind 300
3roleibus: posts big blind 600
*** HOLE CARDS ***
Dealt to casiodk333 [Kc Ad]
wvoron81: folds 
sherban80: folds 
said366: folds 
ApollonK: folds 
calibra1967: folds 
Czaaaar: folds 
Zug94: folds 
casiodk333: raises 900 to 1500
3roleibus: raises 6177 to 7677 and is all-in
casiodk333: calls 6177
*** FLOP *** [Th 2c Jc]
*** TURN *** [Th 2c Jc] [7s]
*** RIVER *** [Th 2c Jc 7s] [Qd]
*** SHOW DOWN ***
casiodk333: shows [Kc Ad] (a straight, Ten to Ace)
3roleibus: shows [Jd 3h] (a pair of Jacks)
casiodk333 collected 15984 from pot
3roleibus finished the tournament in 30111th place
*** SUMMARY ***
Total pot 15984 | Rake 0 
Board [Th 2c Jc 7s Qd]
Seat 1: ApollonK folded before Flop (didn't bet)
Seat 2: calibra1967 folded before Flop (didn't bet)
Seat 3: Czaaaar folded before Flop (didn't bet)
Seat 4: Zug94 (button) folded before Flop (didn't bet)
Seat 5: casiodk333 (small blind) showed [Kc Ad] and won (15984) with a straight, Ten to Ace
Seat 6: 3roleibus (big blind) showed [Jd 3h] and lost with a pair of Jacks
Seat 7: wvoron81 folded before Flop (didn't bet)
Seat 8: sherban80 folded before Flop (didn't bet)
Seat 9: said366 folded before Flop (didn't bet)



PokerStars Hand #132877906350: Tournament #1164585221, $20+$2 USD Hold'em No Limit - Level XV (300/600) - 2015/03/29 23:26:29 CET [2015/03/29 17:26:29 ET]
Table '1164585221 3130' 9-max Seat #5 is the button
Seat 1: ApollonK (31000 in chips) 
Seat 2: calibra1967 (30356 in chips) 
Seat 3: Czaaaar (10227 in chips) 
Seat 4: Zug94 (9900 in chips) 
Seat 5: casiodk333 (31645 in chips) 
Seat 7: wvoron81 (21068 in chips) 
Seat 8: sherban80 (11857 in chips) 
Seat 9: said366 (9886 in chips) 
ApollonK: posts the ante 70
calibra1967: posts the ante 70
Czaaaar: posts the ante 70
Zug94: posts the ante 70
casiodk333: posts the ante 70
wvoron81: posts the ante 70
sherban80: posts the ante 70
said366: posts the ante 70
wvoron81: posts small blind 300
sherban80: posts big blind 600
*** HOLE CARDS ***
Dealt to casiodk333 [Td Qs]
said366: calls 600
ApollonK: folds 
calibra1967: folds 
Czaaaar: folds 
Zug94: raises 2660 to 3260
casiodk333: folds 
wvoron81: raises 17738 to 20998 and is all-in
sherban80: folds 
said366: folds 
Zug94: calls 6570 and is all-in
Uncalled bet (11168) returned to wvoron81
*** FLOP *** [2h 8h 4h]
*** TURN *** [2h 8h 4h] [6h]
*** RIVER *** [2h 8h 4h 6h] [Qh]
*** SHOW DOWN ***
wvoron81: shows [Kd Ks] (a flush, Queen high)
Zug94: shows [Js Jc] (a flush, Queen high)
wvoron81 collected 10710 from pot
Zug94 collected 10710 from pot
*** SUMMARY ***
Total pot 21420 | Rake 0 
Board [2h 8h 4h 6h Qh]
Seat 1: ApollonK folded before Flop (didn't bet)
Seat 2: calibra1967 folded before Flop (didn't bet)
Seat 3: Czaaaar folded before Flop (didn't bet)
Seat 4: Zug94 showed [Js Jc] and won (10710) with a flush, Queen high
Seat 5: casiodk333 (button) folded before Flop (didn't bet)
Seat 7: wvoron81 (small blind) showed [Kd Ks] and won (10710) with a flush, Queen high
Seat 8: sherban80 (big blind) folded before Flop
Seat 9: said366 folded before Flop



PokerStars Hand #132878012253: Tournament #1164585221, $20+$2 USD Hold'em No Limit - Level XV (300/600) - 2015/03/29 23:28:01 CET [2015/03/29 17:28:01 ET]
Table '1164585221 3130' 9-max Seat #7 is the button
Seat 1: ApollonK (30930 in chips) 
Seat 2: calibra1967 (30286 in chips) 
Seat 3: Czaaaar (10157 in chips) 
Seat 4: Zug94 (10710 in chips) 
Seat 5: casiodk333 (31575 in chips) 
Seat 6: Rumcajzz69 (4328 in chips) 
Seat 7: wvoron81 (21878 in chips) 
Seat 8: sherban80 (11187 in chips) 
Seat 9: said366 (9216 in chips) 
ApollonK: posts the ante 70
calibra1967: posts the ante 70
Czaaaar: posts the ante 70
Zug94: posts the ante 70
casiodk333: posts the ante 70
Rumcajzz69: posts the ante 70
wvoron81: posts the ante 70
sherban80: posts the ante 70
said366: posts the ante 70
sherban80: posts small blind 300
said366: posts big blind 600
*** HOLE CARDS ***
Dealt to casiodk333 [5h 3h]
wvoron81 said, "ahahah"
ApollonK: folds 
calibra1967: folds 
Czaaaar: folds 
Zug94: raises 1600 to 2200
casiodk333: folds 
Rumcajzz69: folds 
wvoron81: folds 
sherban80: folds 
said366: calls 1600
*** FLOP *** [Qd 2d 9h]
said366: checks 
Zug94: bets 7200
said366: folds 
Uncalled bet (7200) returned to Zug94
Zug94 collected 5330 from pot
*** SUMMARY ***
Total pot 5330 | Rake 0 
Board [Qd 2d 9h]
Seat 1: ApollonK folded before Flop (didn't bet)
Seat 2: calibra1967 folded before Flop (didn't bet)
Seat 3: Czaaaar folded before Flop (didn't bet)
Seat 4: Zug94 collected (5330)
Seat 5: casiodk333 folded before Flop (didn't bet)
Seat 6: Rumcajzz69 folded before Flop (didn't bet)
Seat 7: wvoron81 (button) folded before Flop (didn't bet)
Seat 8: sherban80 (small blind) folded before Flop
Seat 9: said366 (big blind) folded on the Flop



PokerStars Hand #132878140336: Tournament #1164585221, $20+$2 USD Hold'em No Limit - Level XV (300/600) - 2015/03/29 23:29:52 CET [2015/03/29 17:29:52 ET]
Table '1164585221 3130' 9-max Seat #8 is the button
Seat 1: ApollonK (30860 in chips) 
Seat 2: calibra1967 (30216 in chips) 
Seat 3: Czaaaar (10087 in chips) 
Seat 4: Zug94 (13770 in chips) 
Seat 5: casiodk333 (31505 in chips) 
Seat 6: Rumcajzz69 (4258 in chips) 
Seat 7: wvoron81 (21808 in chips) 
Seat 8: sherban80 (10817 in chips) 
Seat 9: said366 (6946 in chips) 
ApollonK: posts the ante 70
calibra1967: posts the ante 70
Czaaaar: posts the ante 70
Zug94: posts the ante 70
casiodk333: posts the ante 70
Rumcajzz69: posts the ante 70
wvoron81: posts the ante 70
sherban80: posts the ante 70
said366: posts the ante 70
said366: posts small blind 300
ApollonK: posts big blind 600
*** HOLE CARDS ***
Dealt to casiodk333 [Qs 3d]
calibra1967: folds 
Czaaaar: folds 
Zug94: raises 1100 to 1700
casiodk333: folds 
Rumcajzz69: folds 
wvoron81: folds 
sherban80: folds 
said366: folds 
ApollonK: folds 
Uncalled bet (1100) returned to Zug94
Zug94 collected 2130 from pot
*** SUMMARY ***
Total pot 2130 | Rake 0 
Seat 1: ApollonK (big blind) folded before Flop
Seat 2: calibra1967 folded before Flop (didn't bet)
Seat 3: Czaaaar folded before Flop (didn't bet)
Seat 4: Zug94 collected (2130)
Seat 5: casiodk333 folded before Flop (didn't bet)
Seat 6: Rumcajzz69 folded before Flop (didn't bet)
Seat 7: wvoron81 folded before Flop (didn't bet)
Seat 8: sherban80 (button) folded before Flop (didn't bet)
Seat 9: said366 (small blind) folded before Flop



PokerStars Hand #132878213378: Tournament #1164585221, $20+$2 USD Hold'em No Limit - Level XV (300/600) - 2015/03/29 23:31:01 CET [2015/03/29 17:31:01 ET]
Table '1164585221 3130' 9-max Seat #9 is the button
Seat 1: ApollonK (30190 in chips) 
Seat 2: calibra1967 (30146 in chips) 
Seat 3: Czaaaar (10017 in chips) 
Seat 4: Zug94 (15230 in chips) 
Seat 5: casiodk333 (31435 in chips) 
Seat 6: Rumcajzz69 (4188 in chips) 
Seat 7: wvoron81 (21738 in chips) 
Seat 8: sherban80 (10747 in chips) 
Seat 9: said366 (6576 in chips) 
ApollonK: posts the ante 70
calibra1967: posts the ante 70
Czaaaar: posts the ante 70
Zug94: posts the ante 70
casiodk333: posts the ante 70
Rumcajzz69: posts the ante 70
wvoron81: posts the ante 70
sherban80: posts the ante 70
said366: posts the ante 70
ApollonK: posts small blind 300
calibra1967: posts big blind 600
*** HOLE CARDS ***
Dealt to casiodk333 [Th Tc]
Czaaaar: folds 
Zug94: folds 
casiodk333: raises 600 to 1200
Rumcajzz69: folds 
wvoron81: folds 
sherban80: folds 
said366: raises 3930 to 5130
ApollonK: folds 
calibra1967: folds 
casiodk333: raises 3930 to 9060
said366: calls 1376 and is all-in
Uncalled bet (2554) returned to casiodk333
*** FLOP *** [7h 4s 2c]
*** TURN *** [7h 4s 2c] [8h]
*** RIVER *** [7h 4s 2c 8h] [6c]
*** SHOW DOWN ***
casiodk333: shows [Th Tc] (a pair of Tens)
said366: shows [Ac Jh] (high card Ace)
casiodk333 collected 14542 from pot
said366 finished the tournament in 28296th place
*** SUMMARY ***
Total pot 14542 | Rake 0 
Board [7h 4s 2c 8h 6c]
Seat 1: ApollonK (small blind) folded before Flop
Seat 2: calibra1967 (big blind) folded before Flop
Seat 3: Czaaaar folded before Flop (didn't bet)
Seat 4: Zug94 folded before Flop (didn't bet)
Seat 5: casiodk333 showed [Th Tc] and won (14542) with a pair of Tens
Seat 6: Rumcajzz69 folded before Flop (didn't bet)
Seat 7: wvoron81 folded before Flop (didn't bet)
Seat 8: sherban80 folded before Flop (didn't bet)
Seat 9: said366 (button) showed [Ac Jh] and lost with high card Ace



PokerStars Hand #132878262142: Tournament #1164585221, $20+$2 USD Hold'em No Limit - Level XV (300/600) - 2015/03/29 23:31:44 CET [2015/03/29 17:31:44 ET]
Table '1164585221 3130' 9-max Seat #1 is the button
Seat 1: ApollonK (29820 in chips) 
Seat 2: calibra1967 (29476 in chips) 
Seat 3: Czaaaar (9947 in chips) 
Seat 4: Zug94 (15160 in chips) 
Seat 5: casiodk333 (39401 in chips) 
Seat 6: Rumcajzz69 (4118 in chips) 
Seat 7: wvoron81 (21668 in chips) 
Seat 8: sherban80 (10677 in chips) 
Seat 9: RFSD1 (41581 in chips) 
ApollonK: posts the ante 70
calibra1967: posts the ante 70
Czaaaar: posts the ante 70
Zug94: posts the ante 70
casiodk333: posts the ante 70
Rumcajzz69: posts the ante 70
wvoron81: posts the ante 70
sherban80: posts the ante 70
RFSD1: posts the ante 70
calibra1967: posts small blind 300
Czaaaar: posts big blind 600
*** HOLE CARDS ***
Dealt to casiodk333 [Qc 8d]
Zug94: folds 
casiodk333: folds 
Rumcajzz69: folds 
wvoron81: folds 
sherban80: raises 600 to 1200
RFSD1: folds 
ApollonK: folds 
calibra1967: raises 1200 to 2400
Czaaaar: folds 
sherban80: calls 1200
*** FLOP *** [Jd 5d 2d]
calibra1967: bets 1800
sherban80: folds 
Uncalled bet (1800) returned to calibra1967
calibra1967 collected 6030 from pot
*** SUMMARY ***
Total pot 6030 | Rake 0 
Board [Jd 5d 2d]
Seat 1: ApollonK (button) folded before Flop (didn't bet)
Seat 2: calibra1967 (small blind) collected (6030)
Seat 3: Czaaaar (big blind) folded before Flop
Seat 4: Zug94 folded before Flop (didn't bet)
Seat 5: casiodk333 folded before Flop (didn't bet)
Seat 6: Rumcajzz69 folded before Flop (didn't bet)
Seat 7: wvoron81 folded before Flop (didn't bet)
Seat 8: sherban80 folded on the Flop
Seat 9: RFSD1 folded before Flop (didn't bet)



PokerStars Hand #132878325972: Tournament #1164585221, $20+$2 USD Hold'em No Limit - Level XV (300/600) - 2015/03/29 23:32:39 CET [2015/03/29 17:32:39 ET]
Table '1164585221 3130' 9-max Seat #2 is the button
Seat 1: ApollonK (29750 in chips) 
Seat 2: calibra1967 (33036 in chips) 
Seat 3: Czaaaar (9277 in chips) 
Seat 4: Zug94 (15090 in chips) 
Seat 5: casiodk333 (39331 in chips) 
Seat 6: Rumcajzz69 (4048 in chips) 
Seat 7: wvoron81 (21598 in chips) 
Seat 8: sherban80 (8207 in chips) 
Seat 9: RFSD1 (41511 in chips) 
ApollonK: posts the ante 70
calibra1967: posts the ante 70
Czaaaar: posts the ante 70
Zug94: posts the ante 70
casiodk333: posts the ante 70
Rumcajzz69: posts the ante 70
wvoron81: posts the ante 70
sherban80: posts the ante 70
RFSD1: posts the ante 70
Czaaaar: posts small blind 300
Zug94: posts big blind 600
*** HOLE CARDS ***
Dealt to casiodk333 [9h 5h]
casiodk333: folds 
Rumcajzz69: folds 
wvoron81: folds 
sherban80: folds 
RFSD1: folds 
ApollonK: raises 622 to 1222
calibra1967: folds 
Czaaaar: folds 
Zug94: folds 
Uncalled bet (622) returned to ApollonK
ApollonK collected 2130 from pot
ApollonK: doesn't show hand 
*** SUMMARY ***
Total pot 2130 | Rake 0 
Seat 1: ApollonK collected (2130)
Seat 2: calibra1967 (button) folded before Flop (didn't bet)
Seat 3: Czaaaar (small blind) folded before Flop
Seat 4: Zug94 (big blind) folded before Flop
Seat 5: casiodk333 folded before Flop (didn't bet)
Seat 6: Rumcajzz69 folded before Flop (didn't bet)
Seat 7: wvoron81 folded before Flop (didn't bet)
Seat 8: sherban80 folded before Flop (didn't bet)
Seat 9: RFSD1 folded before Flop (didn't bet)



PokerStars Hand #132878366205: Tournament #1164585221, $20+$2 USD Hold'em No Limit - Level XV (300/600) - 2015/03/29 23:33:13 CET [2015/03/29 17:33:13 ET]
Table '1164585221 3130' 9-max Seat #3 is the button
Seat 1: ApollonK (31210 in chips) 
Seat 2: calibra1967 (32966 in chips) 
Seat 3: Czaaaar (8907 in chips) 
Seat 4: Zug94 (14420 in chips) 
Seat 5: casiodk333 (39261 in chips) 
Seat 6: Rumcajzz69 (3978 in chips) 
Seat 7: wvoron81 (21528 in chips) 
Seat 8: sherban80 (8137 in chips) 
Seat 9: RFSD1 (41441 in chips) 
ApollonK: posts the ante 70
calibra1967: posts the ante 70
Czaaaar: posts the ante 70
Zug94: posts the ante 70
casiodk333: posts the ante 70
Rumcajzz69: posts the ante 70
wvoron81: posts the ante 70
sherban80: posts the ante 70
RFSD1: posts the ante 70
Zug94: posts small blind 300
casiodk333: posts big blind 600
*** HOLE CARDS ***
Dealt to casiodk333 [6c 8h]
Rumcajzz69: folds 
wvoron81: folds 
sherban80: folds 
RFSD1: folds 
ApollonK: folds 
calibra1967: folds 
Czaaaar: folds 
Zug94: calls 300
casiodk333: checks 
*** FLOP *** [8s 5h Td]
Zug94: checks 
casiodk333: bets 600
Zug94: calls 600
*** TURN *** [8s 5h Td] [Qh]
Zug94: checks 
casiodk333: checks 
*** RIVER *** [8s 5h Td Qh] [Js]
Zug94: checks 
casiodk333: checks 
*** SHOW DOWN ***
Zug94: shows [7s 6s] (high card Queen)
casiodk333: shows [6c 8h] (a pair of Eights)
casiodk333 collected 3030 from pot
*** SUMMARY ***
Total pot 3030 | Rake 0 
Board [8s 5h Td Qh Js]
Seat 1: ApollonK folded before Flop (didn't bet)
Seat 2: calibra1967 folded before Flop (didn't bet)
Seat 3: Czaaaar (button) folded before Flop (didn't bet)
Seat 4: Zug94 (small blind) showed [7s 6s] and lost with high card Queen
Seat 5: casiodk333 (big blind) showed [6c 8h] and won (3030) with a pair of Eights
Seat 6: Rumcajzz69 folded before Flop (didn't bet)
Seat 7: wvoron81 folded before Flop (didn't bet)
Seat 8: sherban80 folded before Flop (didn't bet)
Seat 9: RFSD1 folded before Flop (didn't bet)



PokerStars Hand #132878474140: Tournament #1164585221, $20+$2 USD Hold'em No Limit - Level XVI (350/700) - 2015/03/29 23:34:46 CET [2015/03/29 17:34:46 ET]
Table '1164585221 3130' 9-max Seat #4 is the button
Seat 1: ApollonK (31140 in chips) 
Seat 2: calibra1967 (32896 in chips) 
Seat 3: Czaaaar (8837 in chips) 
Seat 4: Zug94 (13150 in chips) 
Seat 5: casiodk333 (41021 in chips) 
Seat 6: Rumcajzz69 (3908 in chips) 
Seat 7: wvoron81 (21458 in chips) 
Seat 8: sherban80 (8067 in chips) 
Seat 9: RFSD1 (41371 in chips) 
ApollonK: posts the ante 85
calibra1967: posts the ante 85
Czaaaar: posts the ante 85
Zug94: posts the ante 85
casiodk333: posts the ante 85
Rumcajzz69: posts the ante 85
wvoron81: posts the ante 85
sherban80: posts the ante 85
RFSD1: posts the ante 85
casiodk333: posts small blind 350
Rumcajzz69: posts big blind 700
*** HOLE CARDS ***
Dealt to casiodk333 [Ks 2c]
wvoron81: folds 
sherban80: folds 
RFSD1: raises 700 to 1400
ApollonK: folds 
calibra1967: calls 1400
Czaaaar: folds 
Zug94: folds 
casiodk333: folds 
Rumcajzz69: calls 700
*** FLOP *** [3d Jc 9h]
Rumcajzz69: checks 
RFSD1: checks 
calibra1967: bets 2657
Rumcajzz69: folds 
RFSD1: folds 
Uncalled bet (2657) returned to calibra1967
calibra1967 collected 5315 from pot
*** SUMMARY ***
Total pot 5315 | Rake 0 
Board [3d Jc 9h]
Seat 1: ApollonK folded before Flop (didn't bet)
Seat 2: calibra1967 collected (5315)
Seat 3: Czaaaar folded before Flop (didn't bet)
Seat 4: Zug94 (button) folded before Flop (didn't bet)
Seat 5: casiodk333 (small blind) folded before Flop
Seat 6: Rumcajzz69 (big blind) folded on the Flop
Seat 7: wvoron81 folded before Flop (didn't bet)
Seat 8: sherban80 folded before Flop (didn't bet)
Seat 9: RFSD1 folded on the Flop



PokerStars Hand #132878582892: Tournament #1164585221, $20+$2 USD Hold'em No Limit - Level XVI (350/700) - 2015/03/29 23:36:21 CET [2015/03/29 17:36:21 ET]
Table '1164585221 3130' 9-max Seat #5 is the button
Seat 1: ApollonK (31055 in chips) 
Seat 2: calibra1967 (36726 in chips) 
Seat 3: Czaaaar (8752 in chips) 
Seat 4: Zug94 (13065 in chips) 
Seat 5: casiodk333 (40586 in chips) 
Seat 6: Rumcajzz69 (2423 in chips) 
Seat 7: wvoron81 (21373 in chips) 
Seat 8: sherban80 (7982 in chips) 
Seat 9: RFSD1 (39886 in chips) 
ApollonK: posts the ante 85
calibra1967: posts the ante 85
Czaaaar: posts the ante 85
Zug94: posts the ante 85
casiodk333: posts the ante 85
Rumcajzz69: posts the ante 85
wvoron81: posts the ante 85
sherban80: posts the ante 85
RFSD1: posts the ante 85
Rumcajzz69: posts small blind 350
wvoron81: posts big blind 700
*** HOLE CARDS ***
Dealt to casiodk333 [Kh 6h]
sherban80: raises 700 to 1400
RFSD1: folds 
ApollonK: folds 
calibra1967: folds 
Czaaaar: folds 
Zug94: folds 
casiodk333: folds 
Rumcajzz69: folds 
wvoron81: calls 700
*** FLOP *** [4c 9h Jd]
wvoron81: checks 
sherban80: checks 
*** TURN *** [4c 9h Jd] [Td]
wvoron81: checks 
sherban80: bets 1400
wvoron81: folds 
Uncalled bet (1400) returned to sherban80
sherban80 collected 3915 from pot
*** SUMMARY ***
Total pot 3915 | Rake 0 
Board [4c 9h Jd Td]
Seat 1: ApollonK folded before Flop (didn't bet)
Seat 2: calibra1967 folded before Flop (didn't bet)
Seat 3: Czaaaar folded before Flop (didn't bet)
Seat 4: Zug94 folded before Flop (didn't bet)
Seat 5: casiodk333 (button) folded before Flop (didn't bet)
Seat 6: Rumcajzz69 (small blind) folded before Flop
Seat 7: wvoron81 (big blind) folded on the Turn
Seat 8: sherban80 collected (3915)
Seat 9: RFSD1 folded before Flop (didn't bet)



PokerStars Hand #132878683562: Tournament #1164585221, $20+$2 USD Hold'em No Limit - Level XVI (350/700) - 2015/03/29 23:37:49 CET [2015/03/29 17:37:49 ET]
Table '1164585221 3130' 9-max Seat #6 is the button
Seat 1: ApollonK (30970 in chips) 
Seat 2: calibra1967 (36641 in chips) 
Seat 3: Czaaaar (8667 in chips) 
Seat 4: Zug94 (12980 in chips) 
Seat 5: casiodk333 (40501 in chips) 
Seat 6: Rumcajzz69 (1988 in chips) 
Seat 7: wvoron81 (19888 in chips) 
Seat 8: sherban80 (10412 in chips) 
Seat 9: RFSD1 (39801 in chips) 
ApollonK: posts the ante 85
calibra1967: posts the ante 85
Czaaaar: posts the ante 85
Zug94: posts the ante 85
casiodk333: posts the ante 85
Rumcajzz69: posts the ante 85
wvoron81: posts the ante 85
sherban80: posts the ante 85
RFSD1: posts the ante 85
wvoron81: posts small blind 350
sherban80: posts big blind 700
*** HOLE CARDS ***
Dealt to casiodk333 [Js 6h]
RFSD1: folds 
ApollonK: folds 
calibra1967: folds 
Czaaaar: folds 
Zug94: folds 
casiodk333: raises 1050 to 1750
Rumcajzz69: folds 
wvoron81: folds 
sherban80: folds 
Uncalled bet (1050) returned to casiodk333
casiodk333 collected 2515 from pot
*** SUMMARY ***
Total pot 2515 | Rake 0 
Seat 1: ApollonK folded before Flop (didn't bet)
Seat 2: calibra1967 folded before Flop (didn't bet)
Seat 3: Czaaaar folded before Flop (didn't bet)
Seat 4: Zug94 folded before Flop (didn't bet)
Seat 5: casiodk333 collected (2515)
Seat 6: Rumcajzz69 (button) folded before Flop (didn't bet)
Seat 7: wvoron81 (small blind) folded before Flop
Seat 8: sherban80 (big blind) folded before Flop
Seat 9: RFSD1 folded before Flop (didn't bet)



PokerStars Hand #132878754018: Tournament #1164585221, $20+$2 USD Hold'em No Limit - Level XVI (350/700) - 2015/03/29 23:38:50 CET [2015/03/29 17:38:50 ET]
Table '1164585221 3130' 9-max Seat #7 is the button
Seat 1: ApollonK (30885 in chips) 
Seat 2: calibra1967 (36556 in chips) 
Seat 3: Czaaaar (8582 in chips) 
Seat 4: Zug94 (12895 in chips) 
Seat 5: casiodk333 (42231 in chips) 
Seat 6: Rumcajzz69 (1903 in chips) 
Seat 7: wvoron81 (19453 in chips) 
Seat 8: sherban80 (9627 in chips) 
Seat 9: RFSD1 (39716 in chips) 
ApollonK: posts the ante 85
calibra1967: posts the ante 85
Czaaaar: posts the ante 85
Zug94: posts the ante 85
casiodk333: posts the ante 85
Rumcajzz69: posts the ante 85
wvoron81: posts the ante 85
sherban80: posts the ante 85
RFSD1: posts the ante 85
sherban80: posts small blind 350
RFSD1: posts big blind 700
*** HOLE CARDS ***
Dealt to casiodk333 [9d As]
ApollonK: folds 
calibra1967: folds 
Czaaaar: folds 
Zug94: folds 
casiodk333: raises 700 to 1400
Rumcajzz69: folds 
wvoron81: raises 1750 to 3150
sherban80: folds 
RFSD1: folds 
casiodk333: calls 1750
*** FLOP *** [Ah Ks 4d]
casiodk333: checks 
wvoron81: bets 2450
casiodk333: raises 2800 to 5250
wvoron81: calls 2800
*** TURN *** [Ah Ks 4d] [3h]
casiodk333: bets 11550
wvoron81: folds 
Uncalled bet (11550) returned to casiodk333
casiodk333 collected 18615 from pot
*** SUMMARY ***
Total pot 18615 | Rake 0 
Board [Ah Ks 4d 3h]
Seat 1: ApollonK folded before Flop (didn't bet)
Seat 2: calibra1967 folded before Flop (didn't bet)
Seat 3: Czaaaar folded before Flop (didn't bet)
Seat 4: Zug94 folded before Flop (didn't bet)
Seat 5: casiodk333 collected (18615)
Seat 6: Rumcajzz69 folded before Flop (didn't bet)
Seat 7: wvoron81 (button) folded on the Turn
Seat 8: sherban80 (small blind) folded before Flop
Seat 9: RFSD1 (big blind) folded before Flop



PokerStars Hand #132878885694: Tournament #1164585221, $20+$2 USD Hold'em No Limit - Level XVI (350/700) - 2015/03/29 23:40:47 CET [2015/03/29 17:40:47 ET]
Table '1164585221 3130' 9-max Seat #8 is the button
Seat 1: ApollonK (30800 in chips) 
Seat 2: calibra1967 (36471 in chips) 
Seat 3: Czaaaar (8497 in chips) 
Seat 4: Zug94 (12810 in chips) 
Seat 5: casiodk333 (52361 in chips) 
Seat 6: Rumcajzz69 (1818 in chips) 
Seat 7: wvoron81 (10968 in chips) 
Seat 8: sherban80 (9192 in chips) 
Seat 9: RFSD1 (38931 in chips) 
ApollonK: posts the ante 85
calibra1967: posts the ante 85
Czaaaar: posts the ante 85
Zug94: posts the ante 85
casiodk333: posts the ante 85
Rumcajzz69: posts the ante 85
wvoron81: posts the ante 85
sherban80: posts the ante 85
RFSD1: posts the ante 85
RFSD1: posts small blind 350
ApollonK: posts big blind 700
*** HOLE CARDS ***
Dealt to casiodk333 [5c Js]
calibra1967: raises 700 to 1400
Czaaaar: folds 
Zug94: folds 
casiodk333: folds 
Rumcajzz69: folds 
wvoron81: folds 
sherban80: folds 
RFSD1: folds 
ApollonK: calls 700
*** FLOP *** [5d Ah 5s]
ApollonK: checks 
calibra1967: bets 1957
ApollonK: calls 1957
*** TURN *** [5d Ah 5s] [7h]
ApollonK: checks 
calibra1967: bets 4900
ApollonK: calls 4900
*** RIVER *** [5d Ah 5s 7h] [4s]
ApollonK: checks 
calibra1967: bets 28129 and is all-in
ApollonK: folds [Ad]
Uncalled bet (28129) returned to calibra1967
calibra1967 collected 17629 from pot
calibra1967: shows [Ts Kc]
*** SUMMARY ***
Total pot 17629 | Rake 0 
Board [5d Ah 5s 7h 4s]
Seat 1: ApollonK (big blind) folded on the River
Seat 2: calibra1967 collected (17629)
Seat 3: Czaaaar folded before Flop (didn't bet)
Seat 4: Zug94 folded before Flop (didn't bet)
Seat 5: casiodk333 folded before Flop (didn't bet)
Seat 6: Rumcajzz69 folded before Flop (didn't bet)
Seat 7: wvoron81 folded before Flop (didn't bet)
Seat 8: sherban80 (button) folded before Flop (didn't bet)
Seat 9: RFSD1 (small blind) folded before Flop



PokerStars Hand #132879026968: Tournament #1164585221, $20+$2 USD Hold'em No Limit - Level XVI (350/700) - 2015/03/29 23:42:54 CET [2015/03/29 17:42:54 ET]
Table '1164585221 3130' 9-max Seat #9 is the button
Seat 1: ApollonK (22458 in chips) 
Seat 2: calibra1967 (45758 in chips) 
Seat 3: Czaaaar (8412 in chips) 
Seat 4: Zug94 (12725 in chips) 
Seat 5: casiodk333 (52276 in chips) 
Seat 6: Rumcajzz69 (1733 in chips) 
Seat 7: wvoron81 (10883 in chips) 
Seat 8: sherban80 (9107 in chips) 
Seat 9: RFSD1 (38496 in chips) 
ApollonK: posts the ante 85
calibra1967: posts the ante 85
Czaaaar: posts the ante 85
Zug94: posts the ante 85
casiodk333: posts the ante 85
Rumcajzz69: posts the ante 85
wvoron81: posts the ante 85
sherban80: posts the ante 85
RFSD1: posts the ante 85
ApollonK: posts small blind 350
calibra1967: posts big blind 700
*** HOLE CARDS ***
Dealt to casiodk333 [Jc 3h]
Czaaaar: raises 7627 to 8327 and is all-in
Zug94: folds 
casiodk333: folds 
Rumcajzz69: folds 
wvoron81: folds 
sherban80: folds 
RFSD1: folds 
ApollonK: folds 
calibra1967: folds 
Uncalled bet (7627) returned to Czaaaar
Czaaaar collected 2515 from pot
Czaaaar: doesn't show hand 
*** SUMMARY ***
Total pot 2515 | Rake 0 
Seat 1: ApollonK (small blind) folded before Flop
Seat 2: calibra1967 (big blind) folded before Flop
Seat 3: Czaaaar collected (2515)
Seat 4: Zug94 folded before Flop (didn't bet)
Seat 5: casiodk333 folded before Flop (didn't bet)
Seat 6: Rumcajzz69 folded before Flop (didn't bet)
Seat 7: wvoron81 folded before Flop (didn't bet)
Seat 8: sherban80 folded before Flop (didn't bet)
Seat 9: RFSD1 (button) folded before Flop (didn't bet)



PokerStars Hand #132879048027: Tournament #1164585221, $20+$2 USD Hold'em No Limit - Level XVI (350/700) - 2015/03/29 23:43:13 CET [2015/03/29 17:43:13 ET]
Table '1164585221 3130' 9-max Seat #1 is the button
Seat 1: ApollonK (22023 in chips) 
Seat 2: calibra1967 (44973 in chips) 
Seat 3: Czaaaar (10142 in chips) 
Seat 4: Zug94 (12640 in chips) 
Seat 5: casiodk333 (52191 in chips) 
Seat 6: Rumcajzz69 (1648 in chips) 
Seat 7: wvoron81 (10798 in chips) 
Seat 8: sherban80 (9022 in chips) 
Seat 9: RFSD1 (38411 in chips) 
ApollonK: posts the ante 85
calibra1967: posts the ante 85
Czaaaar: posts the ante 85
Zug94: posts the ante 85
casiodk333: posts the ante 85
Rumcajzz69: posts the ante 85
wvoron81: posts the ante 85
sherban80: posts the ante 85
RFSD1: posts the ante 85
calibra1967: posts small blind 350
Czaaaar: posts big blind 700
*** HOLE CARDS ***
Dealt to casiodk333 [5d 9s]
Zug94: folds 
casiodk333: folds 
Rumcajzz69: raises 863 to 1563 and is all-in
wvoron81: raises 1237 to 2800
sherban80 is disconnected 
sherban80 is connected 
sherban80: folds 
RFSD1: folds 
ApollonK: folds 
calibra1967: folds 
Czaaaar: folds 
Uncalled bet (1237) returned to wvoron81
*** FLOP *** [8c Kd Qh]
*** TURN *** [8c Kd Qh] [Jd]
*** RIVER *** [8c Kd Qh Jd] [8s]
*** SHOW DOWN ***
Rumcajzz69: shows [Ad 8h] (three of a kind, Eights)
wvoron81: shows [9h 9c] (two pair, Nines and Eights)
Rumcajzz69 collected 4941 from pot
*** SUMMARY ***
Total pot 4941 | Rake 0 
Board [8c Kd Qh Jd 8s]
Seat 1: ApollonK (button) folded before Flop (didn't bet)
Seat 2: calibra1967 (small blind) folded before Flop
Seat 3: Czaaaar (big blind) folded before Flop
Seat 4: Zug94 folded before Flop (didn't bet)
Seat 5: casiodk333 folded before Flop (didn't bet)
Seat 6: Rumcajzz69 showed [Ad 8h] and won (4941) with three of a kind, Eights
Seat 7: wvoron81 showed [9h 9c] and lost with two pair, Nines and Eights
Seat 8: sherban80 folded before Flop (didn't bet)
Seat 9: RFSD1 folded before Flop (didn't bet)



PokerStars Hand #132879214627: Tournament #1164585221, $20+$2 USD Hold'em No Limit - Level XVII (400/800) - 2015/03/29 23:45:43 CET [2015/03/29 17:45:43 ET]
Table '1164585221 3130' 9-max Seat #2 is the button
Seat 1: ApollonK (21938 in chips) 
Seat 2: calibra1967 (44538 in chips) 
Seat 3: Czaaaar (9357 in chips) 
Seat 4: Zug94 (12555 in chips) 
Seat 5: casiodk333 (52106 in chips) 
Seat 6: Rumcajzz69 (4941 in chips) 
Seat 7: wvoron81 (9150 in chips) 
Seat 8: sherban80 (8937 in chips) 
Seat 9: RFSD1 (38326 in chips) 
ApollonK: posts the ante 100
calibra1967: posts the ante 100
Czaaaar: posts the ante 100
Zug94: posts the ante 100
casiodk333: posts the ante 100
Rumcajzz69: posts the ante 100
wvoron81: posts the ante 100
sherban80: posts the ante 100
RFSD1: posts the ante 100
Czaaaar: posts small blind 400
Zug94: posts big blind 800
*** HOLE CARDS ***
Dealt to casiodk333 [Jd Jh]
ApollonK said, "what a fish"
casiodk333: raises 1200 to 2000
ApollonK said, "fu"
Rumcajzz69: raises 2841 to 4841 and is all-in
wvoron81: raises 4209 to 9050 and is all-in
sherban80: folds 
RFSD1: folds 
ApollonK: folds 
calibra1967: folds 
Czaaaar: folds 
Zug94: folds 
casiodk333: calls 7050
*** FLOP *** [8c 5d 3s]
*** TURN *** [8c 5d 3s] [6h]
*** RIVER *** [8c 5d 3s 6h] [7h]
*** SHOW DOWN ***
casiodk333: shows [Jd Jh] (a pair of Jacks)
wvoron81: shows [Kd Kh] (a pair of Kings)
wvoron81 collected 8418 from side pot
Rumcajzz69: shows [Qh Ac] (high card Ace)
wvoron81 collected 16623 from main pot
Rumcajzz69 finished the tournament in 22743rd place
*** SUMMARY ***
Total pot 25041 Main pot 16623. Side pot 8418. | Rake 0 
Board [8c 5d 3s 6h 7h]
Seat 1: ApollonK folded before Flop (didn't bet)
Seat 2: calibra1967 (button) folded before Flop (didn't bet)
Seat 3: Czaaaar (small blind) folded before Flop
Seat 4: Zug94 (big blind) folded before Flop
Seat 5: casiodk333 showed [Jd Jh] and lost with a pair of Jacks
Seat 6: Rumcajzz69 showed [Qh Ac] and lost with high card Ace
Seat 7: wvoron81 showed [Kd Kh] and won (25041) with a pair of Kings
Seat 8: sherban80 folded before Flop (didn't bet)
Seat 9: RFSD1 folded before Flop (didn't bet)



PokerStars Hand #132879273252: Tournament #1164585221, $20+$2 USD Hold'em No Limit - Level XVII (400/800) - 2015/03/29 23:46:35 CET [2015/03/29 17:46:35 ET]
Table '1164585221 3130' 9-max Seat #3 is the button
Seat 1: ApollonK (21838 in chips) 
Seat 2: calibra1967 (44438 in chips) 
Seat 3: Czaaaar (8857 in chips) 
Seat 4: Zug94 (11655 in chips) 
Seat 5: casiodk333 (42956 in chips) 
Seat 6: Drunkgordon (29647 in chips) 
Seat 7: wvoron81 (25041 in chips) 
Seat 8: sherban80 (8837 in chips) 
Seat 9: RFSD1 (38226 in chips) 
ApollonK: posts the ante 100
calibra1967: posts the ante 100
Czaaaar: posts the ante 100
Zug94: posts the ante 100
casiodk333: posts the ante 100
Drunkgordon: posts the ante 100
wvoron81: posts the ante 100
sherban80: posts the ante 100
RFSD1: posts the ante 100
Zug94: posts small blind 400
casiodk333: posts big blind 800
*** HOLE CARDS ***
Dealt to casiodk333 [Ac 9h]
Drunkgordon: folds 
wvoron81: folds 
sherban80: folds 
RFSD1: folds 
ApollonK: folds 
calibra1967: folds 
Czaaaar: folds 
Zug94: calls 400
casiodk333: raises 42056 to 42856 and is all-in
Zug94: folds 
Uncalled bet (42056) returned to casiodk333
casiodk333 collected 2500 from pot
*** SUMMARY ***
Total pot 2500 | Rake 0 
Seat 1: ApollonK folded before Flop (didn't bet)
Seat 2: calibra1967 folded before Flop (didn't bet)
Seat 3: Czaaaar (button) folded before Flop (didn't bet)
Seat 4: Zug94 (small blind) folded before Flop
Seat 5: casiodk333 (big blind) collected (2500)
Seat 6: Drunkgordon folded before Flop (didn't bet)
Seat 7: wvoron81 folded before Flop (didn't bet)
Seat 8: sherban80 folded before Flop (didn't bet)
Seat 9: RFSD1 folded before Flop (didn't bet)



PokerStars Hand #132879310881: Tournament #1164585221, $20+$2 USD Hold'em No Limit - Level XVII (400/800) - 2015/03/29 23:47:09 CET [2015/03/29 17:47:09 ET]
Table '1164585221 3130' 9-max Seat #4 is the button
Seat 1: ApollonK (21738 in chips) 
Seat 2: calibra1967 (44338 in chips) 
Seat 3: Czaaaar (8757 in chips) 
Seat 4: Zug94 (10755 in chips) 
Seat 5: casiodk333 (44556 in chips) 
Seat 6: Drunkgordon (29547 in chips) 
Seat 7: wvoron81 (24941 in chips) 
Seat 8: sherban80 (8737 in chips) 
Seat 9: RFSD1 (38126 in chips) 
ApollonK: posts the ante 100
calibra1967: posts the ante 100
Czaaaar: posts the ante 100
Zug94: posts the ante 100
casiodk333: posts the ante 100
Drunkgordon: posts the ante 100
wvoron81: posts the ante 100
sherban80: posts the ante 100
RFSD1: posts the ante 100
casiodk333: posts small blind 400
Drunkgordon: posts big blind 800
*** HOLE CARDS ***
Dealt to casiodk333 [3d 8d]
wvoron81: folds 
sherban80: folds 
RFSD1: folds 
ApollonK: folds 
calibra1967: folds 
Czaaaar: folds 
Zug94: folds 
casiodk333: raises 1200 to 2000
Drunkgordon: calls 1200
*** FLOP *** [3c As Qc]
casiodk333: bets 2222
Drunkgordon: calls 2222
*** TURN *** [3c As Qc] [Ac]
casiodk333: bets 4444
Drunkgordon: raises 4444 to 8888
casiodk333: folds 
Uncalled bet (4444) returned to Drunkgordon
Drunkgordon collected 18232 from pot
Drunkgordon: doesn't show hand 
*** SUMMARY ***
Total pot 18232 | Rake 0 
Board [3c As Qc Ac]
Seat 1: ApollonK folded before Flop (didn't bet)
Seat 2: calibra1967 folded before Flop (didn't bet)
Seat 3: Czaaaar folded before Flop (didn't bet)
Seat 4: Zug94 (button) folded before Flop (didn't bet)
Seat 5: casiodk333 (small blind) folded on the Turn
Seat 6: Drunkgordon (big blind) collected (18232)
Seat 7: wvoron81 folded before Flop (didn't bet)
Seat 8: sherban80 folded before Flop (didn't bet)
Seat 9: RFSD1 folded before Flop (didn't bet)



PokerStars Hand #132879412000: Tournament #1164585221, $20+$2 USD Hold'em No Limit - Level XVII (400/800) - 2015/03/29 23:48:42 CET [2015/03/29 17:48:42 ET]
Table '1164585221 3130' 9-max Seat #5 is the button
Seat 1: ApollonK (21638 in chips) 
Seat 2: calibra1967 (44238 in chips) 
Seat 3: Czaaaar (8657 in chips) 
Seat 4: Zug94 (10655 in chips) 
Seat 5: casiodk333 (35790 in chips) 
Seat 6: Drunkgordon (39013 in chips) 
Seat 7: wvoron81 (24841 in chips) 
Seat 8: sherban80 (8637 in chips) 
Seat 9: RFSD1 (38026 in chips) 
ApollonK: posts the ante 100
calibra1967: posts the ante 100
Czaaaar: posts the ante 100
Zug94: posts the ante 100
casiodk333: posts the ante 100
Drunkgordon: posts the ante 100
wvoron81: posts the ante 100
sherban80: posts the ante 100
RFSD1: posts the ante 100
Drunkgordon: posts small blind 400
wvoron81: posts big blind 800
*** HOLE CARDS ***
Dealt to casiodk333 [9c 7h]
sherban80: raises 800 to 1600
RFSD1: folds 
ApollonK: folds 
calibra1967: folds 
Czaaaar: folds 
Zug94: folds 
casiodk333: folds 
Drunkgordon: folds 
wvoron81: folds 
Uncalled bet (800) returned to sherban80
sherban80 collected 2900 from pot
*** SUMMARY ***
Total pot 2900 | Rake 0 
Seat 1: ApollonK folded before Flop (didn't bet)
Seat 2: calibra1967 folded before Flop (didn't bet)
Seat 3: Czaaaar folded before Flop (didn't bet)
Seat 4: Zug94 folded before Flop (didn't bet)
Seat 5: casiodk333 (button) folded before Flop (didn't bet)
Seat 6: Drunkgordon (small blind) folded before Flop
Seat 7: wvoron81 (big blind) folded before Flop
Seat 8: sherban80 collected (2900)
Seat 9: RFSD1 folded before Flop (didn't bet)



PokerStars Hand #132879436573: Tournament #1164585221, $20+$2 USD Hold'em No Limit - Level XVII (400/800) - 2015/03/29 23:49:04 CET [2015/03/29 17:49:04 ET]
Table '1164585221 3130' 9-max Seat #6 is the button
Seat 1: ApollonK (21538 in chips) 
Seat 2: calibra1967 (44138 in chips) 
Seat 3: Czaaaar (8557 in chips) 
Seat 4: Zug94 (10555 in chips) 
Seat 5: casiodk333 (35690 in chips) 
Seat 6: Drunkgordon (38513 in chips) 
Seat 7: wvoron81 (23941 in chips) 
Seat 8: sherban80 (10637 in chips) 
Seat 9: RFSD1 (37926 in chips) 
ApollonK: posts the ante 100
calibra1967: posts the ante 100
Czaaaar: posts the ante 100
Zug94: posts the ante 100
casiodk333: posts the ante 100
Drunkgordon: posts the ante 100
wvoron81: posts the ante 100
sherban80: posts the ante 100
RFSD1: posts the ante 100
wvoron81: posts small blind 400
sherban80: posts big blind 800
*** HOLE CARDS ***
Dealt to casiodk333 [Ts Ac]
RFSD1: folds 
ApollonK: folds 
calibra1967: folds 
Czaaaar: folds 
Zug94: folds 
casiodk333: calls 800
Drunkgordon: folds 
wvoron81: calls 400
sherban80: checks 
*** FLOP *** [Ad 8h 2c]
wvoron81: checks 
sherban80: checks 
casiodk333: checks 
*** TURN *** [Ad 8h 2c] [4c]
wvoron81: checks 
sherban80: checks 
casiodk333: bets 1600
wvoron81: folds 
sherban80: folds 
Uncalled bet (1600) returned to casiodk333
casiodk333 collected 3300 from pot
*** SUMMARY ***
Total pot 3300 | Rake 0 
Board [Ad 8h 2c 4c]
Seat 1: ApollonK folded before Flop (didn't bet)
Seat 2: calibra1967 folded before Flop (didn't bet)
Seat 3: Czaaaar folded before Flop (didn't bet)
Seat 4: Zug94 folded before Flop (didn't bet)
Seat 5: casiodk333 collected (3300)
Seat 6: Drunkgordon (button) folded before Flop (didn't bet)
Seat 7: wvoron81 (small blind) folded on the Turn
Seat 8: sherban80 (big blind) folded on the Turn
Seat 9: RFSD1 folded before Flop (didn't bet)



PokerStars Hand #132879548279: Tournament #1164585221, $20+$2 USD Hold'em No Limit - Level XVII (400/800) - 2015/03/29 23:50:48 CET [2015/03/29 17:50:48 ET]
Table '1164585221 3130' 9-max Seat #7 is the button
Seat 1: ApollonK (21438 in chips) 
Seat 2: calibra1967 (44038 in chips) 
Seat 3: Czaaaar (8457 in chips) 
Seat 4: Zug94 (10455 in chips) 
Seat 5: casiodk333 (38090 in chips) 
Seat 6: Drunkgordon (38413 in chips) 
Seat 7: wvoron81 (23041 in chips) 
Seat 8: sherban80 (9737 in chips) 
Seat 9: RFSD1 (37826 in chips) 
ApollonK: posts the ante 100
calibra1967: posts the ante 100
Czaaaar: posts the ante 100
Zug94: posts the ante 100
casiodk333: posts the ante 100
Drunkgordon: posts the ante 100
wvoron81: posts the ante 100
sherban80: posts the ante 100
RFSD1: posts the ante 100
sherban80: posts small blind 400
RFSD1: posts big blind 800
*** HOLE CARDS ***
Dealt to casiodk333 [5d 9h]
ApollonK: folds 
calibra1967: folds 
Czaaaar: folds 
Zug94: folds 
casiodk333: folds 
Drunkgordon: raises 800 to 1600
wvoron81: raises 2000 to 3600
sherban80: folds 
RFSD1: folds 
Drunkgordon: folds 
Uncalled bet (2000) returned to wvoron81
wvoron81 collected 5300 from pot
wvoron81: doesn't show hand 
*** SUMMARY ***
Total pot 5300 | Rake 0 
Seat 1: ApollonK folded before Flop (didn't bet)
Seat 2: calibra1967 folded before Flop (didn't bet)
Seat 3: Czaaaar folded before Flop (didn't bet)
Seat 4: Zug94 folded before Flop (didn't bet)
Seat 5: casiodk333 folded before Flop (didn't bet)
Seat 6: Drunkgordon folded before Flop
Seat 7: wvoron81 (button) collected (5300)
Seat 8: sherban80 (small blind) folded before Flop
Seat 9: RFSD1 (big blind) folded before Flop



PokerStars Hand #132879627829: Tournament #1164585221, $20+$2 USD Hold'em No Limit - Level XVII (400/800) - 2015/03/29 23:52:01 CET [2015/03/29 17:52:01 ET]
Table '1164585221 3130' 9-max Seat #8 is the button
Seat 1: ApollonK (21338 in chips) 
Seat 2: calibra1967 (43938 in chips) 
Seat 3: Czaaaar (8357 in chips) 
Seat 4: Zug94 (10355 in chips) 
Seat 5: casiodk333 (37990 in chips) 
Seat 6: Drunkgordon (36713 in chips) 
Seat 7: wvoron81 (26641 in chips) 
Seat 8: sherban80 (9237 in chips) 
Seat 9: RFSD1 (36926 in chips) 
ApollonK: posts the ante 100
calibra1967: posts the ante 100
Czaaaar: posts the ante 100
Zug94: posts the ante 100
casiodk333: posts the ante 100
Drunkgordon: posts the ante 100
wvoron81: posts the ante 100
sherban80: posts the ante 100
RFSD1: posts the ante 100
RFSD1: posts small blind 400
ApollonK: posts big blind 800
*** HOLE CARDS ***
Dealt to casiodk333 [6c Qs]
calibra1967: folds 
Czaaaar: folds 
Zug94: folds 
casiodk333: folds 
Drunkgordon: folds 
wvoron81: folds 
sherban80: folds 
RFSD1: raises 800 to 1600
ApollonK: calls 800
*** FLOP *** [Ac 3c 2c]
RFSD1: bets 2000
ApollonK: calls 2000
*** TURN *** [Ac 3c 2c] [5h]
RFSD1: bets 3000
ApollonK: calls 3000
*** RIVER *** [Ac 3c 2c 5h] [8d]
RFSD1: bets 3200
ApollonK: raises 11438 to 14638 and is all-in
RFSD1: folds 
Uncalled bet (11438) returned to ApollonK
ApollonK collected 20500 from pot
ApollonK: doesn't show hand 
*** SUMMARY ***
Total pot 20500 | Rake 0 
Board [Ac 3c 2c 5h 8d]
Seat 1: ApollonK (big blind) collected (20500)
Seat 2: calibra1967 folded before Flop (didn't bet)
Seat 3: Czaaaar folded before Flop (didn't bet)
Seat 4: Zug94 folded before Flop (didn't bet)
Seat 5: casiodk333 folded before Flop (didn't bet)
Seat 6: Drunkgordon folded before Flop (didn't bet)
Seat 7: wvoron81 folded before Flop (didn't bet)
Seat 8: sherban80 (button) folded before Flop (didn't bet)
Seat 9: RFSD1 (small blind) folded on the River



PokerStars Hand #132879787916: Tournament #1164585221, $20+$2 USD Hold'em No Limit - Level XVIII (500/1000) - 2015/03/29 23:54:30 CET [2015/03/29 17:54:30 ET]
Table '1164585221 3130' 9-max Seat #9 is the button
Seat 1: ApollonK (31938 in chips) 
Seat 2: calibra1967 (43838 in chips) 
Seat 3: Czaaaar (8257 in chips) 
Seat 4: Zug94 (10255 in chips) 
Seat 5: casiodk333 (37890 in chips) 
Seat 6: Drunkgordon (36613 in chips) 
Seat 7: wvoron81 (26541 in chips) 
Seat 8: sherban80 (9137 in chips) 
Seat 9: RFSD1 (27026 in chips) 
ApollonK: posts the ante 125
calibra1967: posts the ante 125
Czaaaar: posts the ante 125
Zug94: posts the ante 125
casiodk333: posts the ante 125
Drunkgordon: posts the ante 125
wvoron81: posts the ante 125
sherban80: posts the ante 125
RFSD1: posts the ante 125
ApollonK: posts small blind 500
calibra1967: posts big blind 1000
*** HOLE CARDS ***
Dealt to casiodk333 [2d 7d]
Czaaaar: folds 
Zug94: folds 
casiodk333: raises 3000 to 4000
Drunkgordon: folds 
wvoron81: folds 
sherban80: folds 
RFSD1: folds 
ApollonK: folds 
calibra1967: folds 
Uncalled bet (3000) returned to casiodk333
casiodk333 collected 3625 from pot
*** SUMMARY ***
Total pot 3625 | Rake 0 
Seat 1: ApollonK (small blind) folded before Flop
Seat 2: calibra1967 (big blind) folded before Flop
Seat 3: Czaaaar folded before Flop (didn't bet)
Seat 4: Zug94 folded before Flop (didn't bet)
Seat 5: casiodk333 collected (3625)
Seat 6: Drunkgordon folded before Flop (didn't bet)
Seat 7: wvoron81 folded before Flop (didn't bet)
Seat 8: sherban80 folded before Flop (didn't bet)
Seat 9: RFSD1 (button) folded before Flop (didn't bet)



PokerStars Hand #132880328015: Tournament #1164585221, $20+$2 USD Hold'em No Limit - Level XVIII (500/1000) - 2015/03/30 0:04:57 CET [2015/03/29 18:04:57 ET]
Table '1164585221 3130' 9-max Seat #1 is the button
Seat 1: ApollonK (31313 in chips) 
Seat 2: calibra1967 (42713 in chips) 
Seat 3: Czaaaar (8132 in chips) 
Seat 4: Zug94 (10130 in chips) 
Seat 5: casiodk333 (40390 in chips) 
Seat 6: Drunkgordon (36488 in chips) 
Seat 7: wvoron81 (26416 in chips) 
Seat 8: sherban80 (9012 in chips) 
Seat 9: RFSD1 (26901 in chips) 
ApollonK: posts the ante 125
calibra1967: posts the ante 125
Czaaaar: posts the ante 125
Zug94: posts the ante 125
casiodk333: posts the ante 125
Drunkgordon: posts the ante 125
wvoron81: posts the ante 125
sherban80: posts the ante 125
RFSD1: posts the ante 125
calibra1967: posts small blind 500
Czaaaar: posts big blind 1000
*** HOLE CARDS ***
Dealt to casiodk333 [8c Ac]
Zug94: folds 
casiodk333: raises 1500 to 2500
Drunkgordon: folds 
wvoron81: folds 
sherban80: folds 
RFSD1: folds 
ApollonK: folds 
calibra1967: folds 
Czaaaar: folds 
Uncalled bet (1500) returned to casiodk333
casiodk333 collected 3625 from pot
*** SUMMARY ***
Total pot 3625 | Rake 0 
Seat 1: ApollonK (button) folded before Flop (didn't bet)
Seat 2: calibra1967 (small blind) folded before Flop
Seat 3: Czaaaar (big blind) folded before Flop
Seat 4: Zug94 folded before Flop (didn't bet)
Seat 5: casiodk333 collected (3625)
Seat 6: Drunkgordon folded before Flop (didn't bet)
Seat 7: wvoron81 folded before Flop (didn't bet)
Seat 8: sherban80 folded before Flop (didn't bet)
Seat 9: RFSD1 folded before Flop (didn't bet)



PokerStars Hand #132880408124: Tournament #1164585221, $20+$2 USD Hold'em No Limit - Level XVIII (500/1000) - 2015/03/30 0:06:13 CET [2015/03/29 18:06:13 ET]
Table '1164585221 3130' 9-max Seat #2 is the button
Seat 1: ApollonK (31188 in chips) 
Seat 2: calibra1967 (42088 in chips) 
Seat 3: Czaaaar (7007 in chips) 
Seat 4: Zug94 (10005 in chips) 
Seat 5: casiodk333 (42890 in chips) 
Seat 6: Drunkgordon (36363 in chips) 
Seat 7: wvoron81 (26291 in chips) 
Seat 8: sherban80 (8887 in chips) 
Seat 9: RFSD1 (26776 in chips) 
ApollonK: posts the ante 125
calibra1967: posts the ante 125
Czaaaar: posts the ante 125
Zug94: posts the ante 125
casiodk333: posts the ante 125
Drunkgordon: posts the ante 125
wvoron81: posts the ante 125
sherban80: posts the ante 125
RFSD1: posts the ante 125
Czaaaar: posts small blind 500
Zug94: posts big blind 1000
*** HOLE CARDS ***
Dealt to casiodk333 [8c 6c]
casiodk333: folds 
Drunkgordon: folds 
wvoron81: folds 
sherban80: folds 
RFSD1: folds 
ApollonK: folds 
calibra1967: folds 
Czaaaar: raises 5882 to 6882 and is all-in
Zug94: folds 
Uncalled bet (5882) returned to Czaaaar
Czaaaar collected 3125 from pot
Czaaaar: doesn't show hand 
*** SUMMARY ***
Total pot 3125 | Rake 0 
Seat 1: ApollonK folded before Flop (didn't bet)
Seat 2: calibra1967 (button) folded before Flop (didn't bet)
Seat 3: Czaaaar (small blind) collected (3125)
Seat 4: Zug94 (big blind) folded before Flop
Seat 5: casiodk333 folded before Flop (didn't bet)
Seat 6: Drunkgordon folded before Flop (didn't bet)
Seat 7: wvoron81 folded before Flop (didn't bet)
Seat 8: sherban80 folded before Flop (didn't bet)
Seat 9: RFSD1 folded before Flop (didn't bet)



PokerStars Hand #132880448995: Tournament #1164585221, $20+$2 USD Hold'em No Limit - Level XVIII (500/1000) - 2015/03/30 0:06:51 CET [2015/03/29 18:06:51 ET]
Table '1164585221 3130' 9-max Seat #3 is the button
Seat 1: ApollonK (31063 in chips) 
Seat 2: calibra1967 (41963 in chips) 
Seat 3: Czaaaar (9007 in chips) 
Seat 4: Zug94 (8880 in chips) 
Seat 5: casiodk333 (42765 in chips) 
Seat 6: Drunkgordon (36238 in chips) 
Seat 7: wvoron81 (26166 in chips) 
Seat 8: sherban80 (8762 in chips) 
Seat 9: RFSD1 (26651 in chips) 
ApollonK: posts the ante 125
calibra1967: posts the ante 125
Czaaaar: posts the ante 125
Zug94: posts the ante 125
casiodk333: posts the ante 125
Drunkgordon: posts the ante 125
wvoron81: posts the ante 125
sherban80: posts the ante 125
RFSD1: posts the ante 125
Zug94: posts small blind 500
casiodk333: posts big blind 1000
*** HOLE CARDS ***
Dealt to casiodk333 [5d 6s]
Drunkgordon: folds 
wvoron81: folds 
sherban80: folds 
RFSD1: folds 
ApollonK: folds 
calibra1967: folds 
Czaaaar: raises 7882 to 8882 and is all-in
Zug94: folds 
casiodk333: folds 
Uncalled bet (7882) returned to Czaaaar
Czaaaar collected 3625 from pot
Czaaaar: doesn't show hand 
*** SUMMARY ***
Total pot 3625 | Rake 0 
Seat 1: ApollonK folded before Flop (didn't bet)
Seat 2: calibra1967 folded before Flop (didn't bet)
Seat 3: Czaaaar (button) collected (3625)
Seat 4: Zug94 (small blind) folded before Flop
Seat 5: casiodk333 (big blind) folded before Flop
Seat 6: Drunkgordon folded before Flop (didn't bet)
Seat 7: wvoron81 folded before Flop (didn't bet)
Seat 8: sherban80 folded before Flop (didn't bet)
Seat 9: RFSD1 folded before Flop (didn't bet)



PokerStars Hand #132880504468: Tournament #1164585221, $20+$2 USD Hold'em No Limit - Level XVIII (500/1000) - 2015/03/30 0:07:44 CET [2015/03/29 18:07:44 ET]
Table '1164585221 3130' 9-max Seat #4 is the button
Seat 1: ApollonK (30938 in chips) 
Seat 2: calibra1967 (41838 in chips) 
Seat 3: Czaaaar (11507 in chips) 
Seat 4: Zug94 (8255 in chips) 
Seat 5: casiodk333 (41640 in chips) 
Seat 6: Drunkgordon (36113 in chips) 
Seat 7: wvoron81 (26041 in chips) 
Seat 8: sherban80 (8637 in chips) 
Seat 9: RFSD1 (26526 in chips) 
ApollonK: posts the ante 125
calibra1967: posts the ante 125
Czaaaar: posts the ante 125
Zug94: posts the ante 125
casiodk333: posts the ante 125
Drunkgordon: posts the ante 125
wvoron81: posts the ante 125
sherban80: posts the ante 125
RFSD1: posts the ante 125
casiodk333: posts small blind 500
Drunkgordon: posts big blind 1000
*** HOLE CARDS ***
Dealt to casiodk333 [2s 2d]
wvoron81: raises 1500 to 2500
sherban80: raises 6012 to 8512 and is all-in
RFSD1: folds 
ApollonK: folds 
calibra1967: raises 33201 to 41713 and is all-in
Czaaaar: folds 
Zug94: calls 8130 and is all-in
casiodk333: folds 
Drunkgordon: folds 
wvoron81: calls 23416 and is all-in
Uncalled bet (15797) returned to calibra1967
*** FLOP *** [Th 9h 6d]
*** TURN *** [Th 9h 6d] [7d]
*** RIVER *** [Th 9h 6d 7d] [7s]
*** SHOW DOWN ***
wvoron81: shows [Ac Ks] (a pair of Sevens)
calibra1967: shows [Ah Qc] (a pair of Sevens - lower kicker)
wvoron81 collected 34808 from side pot-2 
sherban80: shows [Qs Qh] (two pair, Queens and Sevens)
sherban80 collected 1146 from side pot-1 
Zug94: shows [Jc Jh] (two pair, Jacks and Sevens)
sherban80 collected 35145 from main pot
Zug94 finished the tournament in 18977th place
*** SUMMARY ***
Total pot 71099 Main pot 35145. Side pot-1 1146. Side pot-2 34808. | Rake 0 
Board [Th 9h 6d 7d 7s]
Seat 1: ApollonK folded before Flop (didn't bet)
Seat 2: calibra1967 showed [Ah Qc] and lost with a pair of Sevens
Seat 3: Czaaaar folded before Flop (didn't bet)
Seat 4: Zug94 (button) showed [Jc Jh] and lost with two pair, Jacks and Sevens
Seat 5: casiodk333 (small blind) folded before Flop
Seat 6: Drunkgordon (big blind) folded before Flop
Seat 7: wvoron81 showed [Ac Ks] and won (34808) with a pair of Sevens
Seat 8: sherban80 showed [Qs Qh] and won (36291) with two pair, Queens and Sevens
Seat 9: RFSD1 folded before Flop (didn't bet)



PokerStars Hand #132880559530: Tournament #1164585221, $20+$2 USD Hold'em No Limit - Level XVIII (500/1000) - 2015/03/30 0:08:36 CET [2015/03/29 18:08:36 ET]
Table '1164585221 3130' 9-max Seat #5 is the button
Seat 1: ApollonK (30813 in chips) 
Seat 2: calibra1967 (15797 in chips) 
Seat 3: Czaaaar (11382 in chips) 
Seat 4: pstarstiger (21099 in chips) 
Seat 5: casiodk333 (41015 in chips) 
Seat 6: Drunkgordon (34988 in chips) 
Seat 7: wvoron81 (34808 in chips) 
Seat 8: sherban80 (36291 in chips) 
Seat 9: RFSD1 (26401 in chips) 
ApollonK: posts the ante 125
calibra1967: posts the ante 125
Czaaaar: posts the ante 125
pstarstiger: posts the ante 125
casiodk333: posts the ante 125
Drunkgordon: posts the ante 125
wvoron81: posts the ante 125
sherban80: posts the ante 125
RFSD1: posts the ante 125
Drunkgordon: posts small blind 500
wvoron81: posts big blind 1000
*** HOLE CARDS ***
Dealt to casiodk333 [Th Kh]
casiodk333 said, "WOW"
casiodk333 said, "nh"
sherban80: folds 
RFSD1: folds 
ApollonK: folds 
calibra1967: folds 
Czaaaar: folds 
pstarstiger: folds 
casiodk333: raises 1000 to 2000
Drunkgordon: folds 
wvoron81: calls 1000
*** FLOP *** [8d Kc Tc]
wvoron81: checks 
casiodk333: bets 2000
wvoron81: folds 
Uncalled bet (2000) returned to casiodk333
casiodk333 collected 5625 from pot
*** SUMMARY ***
Total pot 5625 | Rake 0 
Board [8d Kc Tc]
Seat 1: ApollonK folded before Flop (didn't bet)
Seat 2: calibra1967 folded before Flop (didn't bet)
Seat 3: Czaaaar folded before Flop (didn't bet)
Seat 4: pstarstiger folded before Flop (didn't bet)
Seat 5: casiodk333 (button) collected (5625)
Seat 6: Drunkgordon (small blind) folded before Flop
Seat 7: wvoron81 (big blind) folded on the Flop
Seat 8: sherban80 folded before Flop (didn't bet)
Seat 9: RFSD1 folded before Flop (didn't bet)



PokerStars Hand #132880621050: Tournament #1164585221, $20+$2 USD Hold'em No Limit - Level XVIII (500/1000) - 2015/03/30 0:09:34 CET [2015/03/29 18:09:34 ET]
Table '1164585221 3130' 9-max Seat #6 is the button
Seat 1: ApollonK (30688 in chips) 
Seat 2: calibra1967 (15672 in chips) 
Seat 3: Czaaaar (11257 in chips) 
Seat 4: pstarstiger (20974 in chips) 
Seat 5: casiodk333 (44515 in chips) 
Seat 6: Drunkgordon (34363 in chips) 
Seat 7: wvoron81 (32683 in chips) 
Seat 8: sherban80 (36166 in chips) 
Seat 9: RFSD1 (26276 in chips) 
ApollonK: posts the ante 125
calibra1967: posts the ante 125
Czaaaar: posts the ante 125
pstarstiger: posts the ante 125
casiodk333: posts the ante 125
Drunkgordon: posts the ante 125
wvoron81: posts the ante 125
sherban80: posts the ante 125
RFSD1: posts the ante 125
wvoron81: posts small blind 500
sherban80: posts big blind 1000
*** HOLE CARDS ***
Dealt to casiodk333 [2s Qc]
RFSD1: folds 
ApollonK: folds 
calibra1967: raises 2000 to 3000
Czaaaar: folds 
pstarstiger: folds 
casiodk333: folds 
Drunkgordon: folds 
wvoron81: folds 
sherban80: folds 
Uncalled bet (2000) returned to calibra1967
calibra1967 collected 3625 from pot
*** SUMMARY ***
Total pot 3625 | Rake 0 
Seat 1: ApollonK folded before Flop (didn't bet)
Seat 2: calibra1967 collected (3625)
Seat 3: Czaaaar folded before Flop (didn't bet)
Seat 4: pstarstiger folded before Flop (didn't bet)
Seat 5: casiodk333 folded before Flop (didn't bet)
Seat 6: Drunkgordon (button) folded before Flop (didn't bet)
Seat 7: wvoron81 (small blind) folded before Flop
Seat 8: sherban80 (big blind) folded before Flop
Seat 9: RFSD1 folded before Flop (didn't bet)



PokerStars Hand #132880659236: Tournament #1164585221, $20+$2 USD Hold'em No Limit - Level XVIII (500/1000) - 2015/03/30 0:10:10 CET [2015/03/29 18:10:10 ET]
Table '1164585221 3130' 9-max Seat #7 is the button
Seat 1: ApollonK (30563 in chips) 
Seat 2: calibra1967 (18172 in chips) 
Seat 3: Czaaaar (11132 in chips) 
Seat 4: pstarstiger (20849 in chips) 
Seat 5: casiodk333 (44390 in chips) 
Seat 6: Drunkgordon (34238 in chips) 
Seat 7: wvoron81 (32058 in chips) 
Seat 8: sherban80 (35041 in chips) 
Seat 9: RFSD1 (26151 in chips) 
ApollonK: posts the ante 125
calibra1967: posts the ante 125
Czaaaar: posts the ante 125
pstarstiger: posts the ante 125
casiodk333: posts the ante 125
Drunkgordon: posts the ante 125
wvoron81: posts the ante 125
sherban80: posts the ante 125
RFSD1: posts the ante 125
sherban80: posts small blind 500
RFSD1: posts big blind 1000
*** HOLE CARDS ***
Dealt to casiodk333 [Qd 9d]
ApollonK: folds 
calibra1967: raises 2000 to 3000
Czaaaar: folds 
pstarstiger: folds 
casiodk333: calls 3000
Drunkgordon: folds 
wvoron81: folds 
sherban80: folds 
RFSD1: calls 2000
*** FLOP *** [8s 7d 5d]
RFSD1: checks 
calibra1967: bets 6000
casiodk333: raises 35265 to 41265 and is all-in
RFSD1: calls 23026 and is all-in
calibra1967: calls 9047 and is all-in
Uncalled bet (18239) returned to casiodk333
*** TURN *** [8s 7d 5d] [4s]
*** RIVER *** [8s 7d 5d 4s] [Kh]
*** SHOW DOWN ***
RFSD1: shows [8h 8d] (three of a kind, Eights)
casiodk333: shows [Qd 9d] (high card King)
RFSD1 collected 15958 from side pot
calibra1967: shows [Tc Ts] (a pair of Tens)
RFSD1 collected 55766 from main pot
calibra1967 finished the tournament in 18091st place
*** SUMMARY ***
Total pot 71724 Main pot 55766. Side pot 15958. | Rake 0 
Board [8s 7d 5d 4s Kh]
Seat 1: ApollonK folded before Flop (didn't bet)
Seat 2: calibra1967 showed [Tc Ts] and lost with a pair of Tens
Seat 3: Czaaaar folded before Flop (didn't bet)
Seat 4: pstarstiger folded before Flop (didn't bet)
Seat 5: casiodk333 showed [Qd 9d] and lost with high card King
Seat 6: Drunkgordon folded before Flop (didn't bet)
Seat 7: wvoron81 (button) folded before Flop (didn't bet)
Seat 8: sherban80 (small blind) folded before Flop
Seat 9: RFSD1 (big blind) showed [8h 8d] and won (71724) with three of a kind, Eights



PokerStars Hand #132880752918: Tournament #1164585221, $20+$2 USD Hold'em No Limit - Level XVIII (500/1000) - 2015/03/30 0:11:39 CET [2015/03/29 18:11:39 ET]
Table '1164585221 3868' 9-max Seat #1 is the button
Seat 1: vhessel (31472 in chips) 
Seat 2: caio_pimenta (47906 in chips) 
Seat 3: 92Maniac (99767 in chips) 
Seat 4: casiodk333 (18239 in chips) 
Seat 5: flushking599 (32602 in chips) 
Seat 6: eliassen20 (13597 in chips) 
Seat 7: chefdbl (28363 in chips) 
Seat 8: phewton (108820 in chips) 
Seat 9: illscoopu (43384 in chips) 
vhessel: posts the ante 125
caio_pimenta: posts the ante 125
92Maniac: posts the ante 125
casiodk333: posts the ante 125
flushking599: posts the ante 125
eliassen20: posts the ante 125
chefdbl: posts the ante 125
phewton: posts the ante 125
illscoopu: posts the ante 125
caio_pimenta: posts small blind 500
92Maniac: posts big blind 1000
*** HOLE CARDS ***
Dealt to casiodk333 [Jd 2d]
casiodk333: folds 
flushking599: folds 
eliassen20: folds 
chefdbl: folds 
phewton: raises 2000 to 3000
illscoopu: folds 
vhessel: folds 
caio_pimenta: folds 
92Maniac: folds 
Uncalled bet (2000) returned to phewton
phewton collected 3625 from pot
phewton: doesn't show hand 
*** SUMMARY ***
Total pot 3625 | Rake 0 
Seat 1: vhessel (button) folded before Flop (didn't bet)
Seat 2: caio_pimenta (small blind) folded before Flop
Seat 3: 92Maniac (big blind) folded before Flop
Seat 4: casiodk333 folded before Flop (didn't bet)
Seat 5: flushking599 folded before Flop (didn't bet)
Seat 6: eliassen20 folded before Flop (didn't bet)
Seat 7: chefdbl folded before Flop (didn't bet)
Seat 8: phewton collected (3625)
Seat 9: illscoopu folded before Flop (didn't bet)



PokerStars Hand #132880796510: Tournament #1164585221, $20+$2 USD Hold'em No Limit - Level XVIII (500/1000) - 2015/03/30 0:12:21 CET [2015/03/29 18:12:21 ET]
Table '1164585221 3868' 9-max Seat #2 is the button
Seat 1: vhessel (31347 in chips) 
Seat 2: caio_pimenta (47281 in chips) 
Seat 3: 92Maniac (98642 in chips) 
Seat 4: casiodk333 (18114 in chips) 
Seat 5: flushking599 (32477 in chips) 
Seat 6: eliassen20 (13472 in chips) 
Seat 7: chefdbl (28238 in chips) 
Seat 8: phewton (111320 in chips) 
Seat 9: illscoopu (43259 in chips) 
vhessel: posts the ante 125
caio_pimenta: posts the ante 125
92Maniac: posts the ante 125
casiodk333: posts the ante 125
flushking599: posts the ante 125
eliassen20: posts the ante 125
chefdbl: posts the ante 125
phewton: posts the ante 125
illscoopu: posts the ante 125
92Maniac: posts small blind 500
casiodk333: posts big blind 1000
*** HOLE CARDS ***
Dealt to casiodk333 [6s Qs]
flushking599: folds 
eliassen20: calls 1000
chefdbl: calls 1000
phewton: folds 
illscoopu: folds 
vhessel: folds 
caio_pimenta: folds 
92Maniac: calls 500
casiodk333: checks 
*** FLOP *** [7d Ks 8d]
92Maniac: checks 
casiodk333: checks 
eliassen20: bets 1000
chefdbl: folds 
92Maniac: folds 
casiodk333: folds 
Uncalled bet (1000) returned to eliassen20
eliassen20 collected 5125 from pot
*** SUMMARY ***
Total pot 5125 | Rake 0 
Board [7d Ks 8d]
Seat 1: vhessel folded before Flop (didn't bet)
Seat 2: caio_pimenta (button) folded before Flop (didn't bet)
Seat 3: 92Maniac (small blind) folded on the Flop
Seat 4: casiodk333 (big blind) folded on the Flop
Seat 5: flushking599 folded before Flop (didn't bet)
Seat 6: eliassen20 collected (5125)
Seat 7: chefdbl folded on the Flop
Seat 8: phewton folded before Flop (didn't bet)
Seat 9: illscoopu folded before Flop (didn't bet)



PokerStars Hand #132880859255: Tournament #1164585221, $20+$2 USD Hold'em No Limit - Level XVIII (500/1000) - 2015/03/30 0:13:23 CET [2015/03/29 18:13:23 ET]
Table '1164585221 3868' 9-max Seat #3 is the button
Seat 1: vhessel (31222 in chips) 
Seat 2: caio_pimenta (47156 in chips) 
Seat 3: 92Maniac (97517 in chips) 
Seat 4: casiodk333 (16989 in chips) 
Seat 5: flushking599 (32352 in chips) 
Seat 6: eliassen20 (17472 in chips) 
Seat 7: chefdbl (27113 in chips) 
Seat 8: phewton (111195 in chips) 
Seat 9: illscoopu (43134 in chips) 
vhessel: posts the ante 125
caio_pimenta: posts the ante 125
92Maniac: posts the ante 125
casiodk333: posts the ante 125
flushking599: posts the ante 125
eliassen20: posts the ante 125
chefdbl: posts the ante 125
phewton: posts the ante 125
illscoopu: posts the ante 125
casiodk333: posts small blind 500
flushking599: posts big blind 1000
*** HOLE CARDS ***
Dealt to casiodk333 [Qs 6h]
eliassen20: folds 
chefdbl: folds 
phewton: folds 
illscoopu: folds 
vhessel: folds 
caio_pimenta: raises 1000 to 2000
92Maniac: folds 
casiodk333: raises 14864 to 16864 and is all-in
flushking599: folds 
caio_pimenta: calls 14864
*** FLOP *** [Kh 9c 9h]
*** TURN *** [Kh 9c 9h] [Ac]
*** RIVER *** [Kh 9c 9h Ac] [3d]
*** SHOW DOWN ***
casiodk333: shows [Qs 6h] (a pair of Nines)
caio_pimenta: shows [6c 6s] (two pair, Nines and Sixes)
caio_pimenta collected 35853 from pot
casiodk333 finished the tournament in 17356th place
*** SUMMARY ***
Total pot 35853 | Rake 0 
Board [Kh 9c 9h Ac 3d]
Seat 1: vhessel folded before Flop (didn't bet)
Seat 2: caio_pimenta showed [6c 6s] and won (35853) with two pair, Nines and Sixes
Seat 3: 92Maniac (button) folded before Flop (didn't bet)
Seat 4: casiodk333 (small blind) showed [Qs 6h] and lost with a pair of Nines
Seat 5: flushking599 (big blind) folded before Flop
Seat 6: eliassen20 folded before Flop (didn't bet)
Seat 7: chefdbl folded before Flop (didn't bet)
Seat 8: phewton folded before Flop (didn't bet)
Seat 9: illscoopu folded before Flop (didn't bet)



